Id	indegree	outdegree	Degree	modularity_class	pageranks
You	3200	384	3584	13	0,006796
Lulz	3987	117	4104	1	0,005699
Faggot	3827	73	3900	0	0,005615
Retard	3998	126	4124	38	0,004958
Homosexuality	3495	212	3707	40	0,004869
Internets	2534	181	2715	3	0,004832
Fail	3740	56	3796	32	0,004761
Rape	3394	163	3557	39	0,004729
Furfag	2852	231	3083	31	0,004478
Liar	3600	60	3660	19	0,004437
Troll	3044	110	3154	41	0,004029
Cock	2541	214	2755	63	0,003954
Fact	2965	94	3059	49	0,003929
Shit no one cares about	3292	50	3342	15	0,003812
Shit	3096	6	3102	34	0,003792
Jews	2356	243	2599	17	0,003672
Nigger	2346	240	2586	35	0,003627
Over 9000	2467	60	2527	11	0,003462
Fat	2258	154	2412	52	0,003336
At least 100	2134	34	2168	47	0,003311
IRL	1824	48	1872	8	0,003265
Whore	2428	128	2556	36	0,003229
Emo	2019	198	2217	12	0,003201
Secks	1900	95	1995	50	0,003009
Fap	2165	183	2348	18	0,002917
An hero	2242	160	2402	58	0,002912
Goatse	1831	138	1969	6	0,002902
4chan	1482	326	1808	9	0,002891
Butthurt	2649	86	2735	24	0,002886
Pedophilia	2053	191	2244	53	0,002715
Pwnt	1826	79	1905	60	0,002708
Sick fuck	1609	195	1804	22	0,002607
Buttsecks	1822	59	1881	40	0,002595
Some argue	1508	32	1540	29	0,002537
Bullshit	2258	82	2340	23	0,002537
Asperger's Syndrome	2141	289	2430	7	0,002479
Vagoo	1490	81	1571	39	0,002391
Pr0n	1489	108	1597	18	0,002388
Your Mom	1140	112	1252	54	0,002355
AIDS	1395	84	1479	40	0,002354
Unwarranted Self-Importance	2112	102	2214	51	0,002279
B/	1396	167	1563	9	0,002237
Wapanese	1328	220	1548	28	0,002212
Wikipedia	1056	224	1280	2	0,002208
Crap	1268	117	1385	21	0,002136
Encyclop√¶dia Dramatica	976	100	1076	2	0,002117
Unfunny	1357	104	1461	61	0,00211
Jewnited States of Americunts	1344	291	1635	37	0,002098
TL;DR	1391	40	1431	5	0,002096
Anonymous	1493	131	1624	26	0,002087
16-year-old girl	1404	143	1547	21	0,002083
Wimmins	1241	222	1463	39	0,00208
YOU ARE DOING IT WRONG	985	66	1051	21	0,002062
13-year-old boy	1582	198	1780	4	0,00202
Attention Whore	1720	99	1819	36	0,002015
Basement-dweller	1724	155	1879	49	0,002004
YouTube	1535	202	1737	48	0,001893
Insane	1736	176	1912	30	0,001883
LiveJournal	880	68	948	8	0,001881
Lol	1454	47	1501	48	0,001853
Banned	1567	161	1728	24	0,001832
Fag	1422	7	1429	33	0,001827
Last Thursday	1574	25	1599	53	0,001777
Cum	1173	40	1213	20	0,001772
Lolicon	1244	95	1339	28	0,001736
Nazi	1283	171	1454	37	0,001719
Meme	928	74	1002	9	0,001717
Party Van	1129	75	1204	9	0,001702
LOL WUT	1615	46	1661	21	0,001684
God	1025	265	1290	46	0,00168
Drug	1063	217	1280	35	0,001631
Chris-chan	1040	244	1284	7	0,001622
The Internet is serious business	1341	67	1408	5	0,001619
Adolf Hitler	976	157	1133	37	0,001619
Animu	1013	236	1249	28	0,001613
BoyChat	215	15	230	43	0,001592
Moar	999	27	1026	21	0,001584
Irony	1232	55	1287	62	0,001572
Epic Win	1156	66	1222	32	0,001559
Fucktard	1190	82	1272	16	0,001529
Newbie	961	41	1002	9	0,001524
Lesbian	954	109	1063	42	0,00151
Suicide	1025	196	1221	13	0,001507
Japan	832	173	1005	28	0,001503
Americunts	909	234	1143	37	0,001486
Pedobear	757	158	915	53	0,001442
Islam	762	304	1066	37	0,001429
W	586	149	735	14	0,001429
Barack Obama	406	235	641	14	0,001425
Fellatio	993	52	1045	54	0,001424
DeviantART	1142	291	1433	21	0,001414
Incontinent Student Bodies	1409	51	1460	16	0,001403
Drama	1093	41	1134	8	0,001392
I did it for the lulz	850	160	1010	1	0,001389
Azn	953	147	1100	11	0,001386
Christian	945	284	1229	46	0,001361
Stupid	1033	63	1096	24	0,001335
CP	857	73	930	53	0,001324
White Devils	897	198	1095	35	0,001318
Jesus	768	182	950	46	0,001275
Internet Tough Guy	1151	164	1315	51	0,001264
DO NOT WANT	771	61	832	56	0,001263
Pussy	964	6	970	61	0,001258
Bitch	1024	33	1057	36	0,001251
No	1230	52	1282	44	0,001247
Feminism	547	184	731	39	0,001247
Failbook	778	249	1027	59	0,001229
Old people	722	102	824	6	0,001219
Incest	862	44	906	42	0,001213
Scientology	721	235	956	26	0,001211
ED	709	21	730	48	0,001211
What	1084	114	1198	56	0,001204
Asking for it	838	64	902	39	0,001198
1337	589	60	649	10	0,001188
GTFO	827	25	852	27	0,001178
Rule 34	741	166	907	9	0,001174
Barack Hussein Obama	421	2	423	14	0,00116
Death	748	52	800	13	0,001142
Tits	818	45	863	28	0,001142
Old media	676	55	731	14	0,001125
Virgin	904	100	1004	38	0,001125
Profit	637	57	694	57	0,001107
09-Nov	653	145	798	37	0,001105
My Little Pony	362	175	537	7	0,001102
RAGE	984	119	1103	61	0,001091
Camwhore	687	101	788	8	0,001086
Communism	670	156	826	14	0,001081
Mexico	753	231	984	35	0,001075
Bestiality	648	101	749	31	0,001074
Awesome	593	152	745	5	0,001058
JEWS DID WTC	486	68	554	17	0,001056
China	594	191	785	11	0,001054
The Google	658	165	823	10	0,001051
IRC	479	46	525	41	0,001046
In the ass	489	9	498	0	0,001043
Old meme	480	99	579	9	0,001041
MySpace	727	200	927	12	0,001031
Holocaust	616	97	713	17	0,001029
Money	710	90	800	17	0,00102
France	490	250	740	37	0,001018
Ugly	806	48	854	36	0,00101
WTF	920	23	943	57	0,000999
Faux News	456	156	612	14	0,000991
ALL CAPS	728	39	767	64	0,000989
Nerd	706	93	799	10	0,000982
Srsly	710	47	757	49	0,000982
Brony	442	192	634	7	0,000977
Pok√©mon	659	295	954	28	0,000969
Typical	558	54	612	49	0,000957
Cat	353	111	464	25	0,00095
United States of Australia	514	222	736	59	0,000943
Divide by zero	598	57	655	46	0,000935
Ass	670	20	690	34	0,00093
Delete fucking everything	1017	172	1189	44	0,000906
Lol-cow	823	175	998	7	0,000903
United Kingdom	554	225	779	37	0,000902
Redneck	695	94	789	35	0,000888
Soviet Canuckistan	554	144	698	37	0,00088
Copypasta	532	60	592	9	0,000869
Unrealistic expectations	874	137	1011	27	0,000863
Transgender	660	168	828	19	0,000862
Flame Wars	459	75	534	41	0,000858
Liberalism	481	256	737	14	0,00085
Trap	643	63	706	28	0,000845
Cancer	650	65	715	9	0,000844
Alcohol	511	151	662	35	0,000842
Idiot	774	31	805	55	0,000839
Atheist	409	284	693	46	0,000831
Powerword	947	32	979	7	0,000824
Russia	520	212	732	37	0,000822
Murder	493	238	731	27	0,000822
Fantard	950	140	1090	49	0,000819
Jew Gold	690	26	716	17	0,000819
Noone	642	23	665	41	0,000815
Evil-unveiled.com/Annabelleigh.net	115	13	128	43	0,000812
KILL IT WITH FIRE	448	36	484	22	0,00081
Dying alone	511	248	759	7	0,00081
Satan	580	118	698	46	0,000807
Shotacon	427	73	500	28	0,000807
Republican	467	124	591	14	0,000806
The Cancer That Is Killing /b/	563	137	700	9	0,000803
Tumblr	498	190	688	19	0,000802
Sand niggers	469	137	606	37	0,000799
Hippie	495	104	599	14	0,000793
Anti-lulz	387	80	467	1	0,000788
Something Awful	374	179	553	8	0,000784
Social Justice	594	148	742	19	0,000783
BDSM	576	66	642	39	0,000779
Liberal	529	9	538	14	0,000775
Hacker	681	169	850	10	0,000765
Captain Obvious	583	60	643	17	0,000765
Religion	339	123	462	46	0,000754
Delicious Cake	352	76	428	9	0,000754
Feminist	411	2	413	19	0,000752
Hentai	469	90	559	28	0,000752
So i herd u liek mudkip	359	122	481	9	0,000745
Moot	395	110	505	9	0,000731
Twatter	606	154	760	19	0,00073
DO IT FAGGOT	530	57	587	13	0,000727
Forced Meme	425	187	612	9	0,000727
Racism	657	191	848	35	0,000726
Pain Series	423	20	443	6	0,000724
Loser	725	81	806	34	0,000712
Oh exploitable	363	134	497	9	0,000706
Uncyclopedia	307	107	414	2	0,000706
Europe	360	128	488	37	0,000704
Sock puppet	639	78	717	2	0,0007
Pedo	567	6	573	53	0,000699
Men	402	55	457	39	0,000699
Weblog	400	47	447	48	0,000696
2005	162	42	204	8	0,000696
????	355	21	376	57	0,000695
Adobe¬Æ Photoshop¬Æ	482	49	531	9	0,000695
Moralfag	355	94	449	26	0,000694
Prostitute	519	44	563	36	0,000689
O rly	454	60	514	48	0,000688
PROTIP	378	22	400	26	0,000683
Girlvinyl	294	56	350	52	0,000677
Evil-unveiled.com/Pedospeak	128	11	139	43	0,000673
Wigger	458	68	526	12	0,00067
God Hates Fags	296	180	476	40	0,00067
Cocaine	398	39	437	35	0,000669
Facepalm	492	75	567	32	0,000669
Hipster	536	130	666	12	0,000669
Pro-Ana	366	106	472	52	0,000668
Africa	356	115	471	35	0,000668
Evil-unveiled.com/Free Spirits Coalition	58	42	100	43	0,000665
The Donald	388	162	550	19	0,000663
Terrorist	477	74	551	37	0,00066
Epic Toilet Story	10	13	23	40	0,000659
Science	353	90	443	46	0,000655
NO U	357	53	410	46	0,000655
Star Wars	409	213	622	33	0,000654
Goth	511	133	644	12	0,000653
Crybaby	306	47	353	24	0,000653
Harry Potter	314	198	512	6	0,000651
HAHAHA DISREGARD THAT, I SUCK COCKS	439	27	466	26	0,000651
Nigra	385	46	431	35	0,000647
Jailbait	440	40	480	28	0,000641
Dorian Thorn	72	13	85	8	0,000636
Lemonparty	400	34	434	6	0,000634
OTI	187	10	197	41	0,000629
2009	265	145	410	48	0,000629
Abortion	446	141	587	46	0,000626
Hell	335	28	363	46	0,000622
Pretty cool guy	398	118	516	49	0,00062
Germany	291	105	396	37	0,00062
Poor	441	67	508	35	0,000615
Yiff	488	74	562	31	0,000613
Amirite	519	18	537	0	0,00061
Upper Decker	6	10	16	34	0,00061
Michael Jackson	307	191	498	53	0,000608
Otherkin	414	107	521	31	0,000608
Gun	339	245	584	58	0,000606
Dildo	409	61	470	40	0,000602
The Man	498	66	564	35	0,000601
England	338	225	563	37	0,000599
Douchebag	502	67	569	0	0,000587
2007	298	160	458	58	0,00058
Cops	492	101	593	35	0,000577
Not	385	42	427	47	0,000572
Offended	394	16	410	6	0,000568
Bible	293	136	429	46	0,000564
2012 (disambiguation)	306	8	314	14	0,000563
Sarcasm	607	44	651	15	0,000563
Twilight	322	192	514	32	0,000562
Trying too hard	470	105	575	7	0,000562
2006	241	145	386	8	0,000561
The Game	330	56	386	49	0,00056
Oneoneone	303	38	341	21	0,000559
Moderator	512	84	596	9	0,000558
Weed	418	66	484	35	0,000558
Black	347	3	350	63	0,000557
Spam	513	51	564	64	0,000556
Senator Barack Hussein Obama	25	144	169	35	0,000553
Jameth	161	77	238	8	0,000551
Children	377	63	440	13	0,000551
Israel	307	66	373	37	0,00055
Self Injury	313	132	445	12	0,000549
Dick	390	19	409	34	0,000543
Internet celebrity	465	194	659	8	0,000543
Leftard	319	77	396	14	0,000543
Al Gore	206	66	272	14	0,00054
Forum	339	165	504	3	0,000537
World of Warcraft	325	140	465	49	0,000535
Mormon	301	150	451	46	0,000531
OL	130	4	134	46	0,000531
Teenager	337	148	485	12	0,00053
Teh	196	27	223	3	0,000529
Apple	345	149	494	10	0,000527
Conservatism	374	220	594	14	0,000526
2013	221	47	268	58	0,000525
Not gay	316	50	366	40	0,000525
I Came	281	39	320	39	0,000523
For great justice	350	19	369	56	0,000522
Redundant	241	1	242	19	0,000522
Grammar Nazi	238	58	296	3	0,000521
A Cat Is Fine Too	159	42	201	25	0,000521
India	313	158	471	37	0,00052
Baby Fuck	233	55	288	39	0,00052
Stfu	390	46	436	27	0,000518
EPIC	481	61	542	32	0,000517
Fat Larry's Band	259	316	575	12	0,000512
Hypocrisy	586	64	650	24	0,000511
Docs	606	101	707	48	0,000505
Luser	385	21	406	10	0,000501
OMG	296	53	349	57	0,000499
TheAmazingAtheist	167	104	271	46	0,000498
Hillary Clinton	244	172	416	19	0,000493
Evil-unveiled.com/Boylover.net	72	1	73	43	0,000493
Victim complex	397	119	516	39	0,000492
Prison	348	94	442	39	0,000492
Guro	310	74	384	22	0,000491
Internet Disease	234	39	273	8	0,000489
Computer Science III	341	77	418	10	0,000488
Almost raped	355	95	450	39	0,000487
THE BEST	215	65	280	9	0,000487
Ghey	180	18	198	0	0,000487
Conspiracy Theory	385	118	503	17	0,000487
Trolling IRL	286	198	484	37	0,000485
A challenger appears	182	21	203	9	0,000485
MS Paint	336	27	363	21	0,000484
South Park	245	235	480	34	0,000475
Italy	243	112	355	37	0,000473
Worldwide Masonic Conspiracy	238	89	327	17	0,00047
Tubgirl	260	26	286	6	0,000467
Catholic	228	136	364	46	0,000467
Chikins	283	62	345	35	0,000466
Josef Fritzl	257	148	405	39	0,000465
Windows	251	155	406	10	0,000463
Music	336	213	549	12	0,000461
McDonald's	245	78	323	41	0,000459
Jew York City	316	86	402	35	0,000459
Boredom	449	36	485	60	0,000459
Desu	250	88	338	9	0,000457
OP	176	6	182	9	0,000457
English	208	45	253	37	0,000454
2011	223	138	361	59	0,000454
Necrophilia	272	74	346	22	0,00045
Engrish	245	30	275	28	0,00045
Pool's Closed	199	42	241	9	0,000449
Gaia Online	241	198	439	9	0,000448
Television	233	27	260	34	0,000447
PROJECT CHANOLOGY	216	62	278	26	0,000445
Bisexual	308	67	375	12	0,000442
Fetish	378	70	448	31	0,000442
B/tard	285	56	341	9	0,000442
Disney	333	175	508	34	0,00044
2008	283	119	402	48	0,00044
Funny	253	67	320	13	0,000439
EDiot	255	87	342	48	0,000439
Video games	349	193	542	49	0,000438
A winner is you	245	47	292	58	0,000438
Rap	262	159	421	35	0,000437
Shit Bricks	296	36	332	9	0,000436
NORP	311	61	372	7	0,000436
Piss	300	33	333	22	0,000434
Lunix	227	118	345	10	0,000433
Raptor Jesus	212	40	252	46	0,000433
Slavery	323	55	378	35	0,000433
Columbine	316	138	454	58	0,000431
Jimbo Wales	257	143	400	2	0,00043
Evil-unveiled.com/LostBoy	2	5	7	43	0,00043
Internet stalking	438	90	528	59	0,000427
Iraq	254	128	382	37	0,000422
I Can Has Cheezburger?	169	79	248	25	0,000422
Team Fortress 2	189	169	358	49	0,000422
FanFiction	433	98	531	21	0,00042
Reddit	306	232	538	19	0,000418
Image Macro	115	33	148	9	0,000417
JewTube	345	10	355	48	0,000416
Poland	148	132	280	37	0,000416
Cockmongler	207	45	252	9	0,000414
Sonic the Hedgehog	428	282	710	7	0,000414
College	305	138	443	11	0,000413
Capitalism	191	91	282	14	0,000411
Wikipedophile	193	79	272	2	0,000404
Too lazy	384	28	412	61	0,000404
Politics	208	35	243	14	0,000403
Spics	370	61	431	35	0,000402
Web 2.0	230	49	279	2	0,000402
Âçê	199	5	204	37	0,000402
EVAR	225	12	237	8	0,000401
Common knowledge	256	73	329	3	0,000401
Chris Hansen	294	89	383	53	0,0004
World War II	244	97	341	37	0,0004
Gay Nigger Association of America	217	46	263	41	0,0004
White Knighting	593	89	682	19	0,0004
300	240	78	318	9	0,000398
Justin Bieber	234	209	443	12	0,000396
STD	227	45	272	36	0,000395
School	273	273	546	58	0,000393
White trash	298	75	373	35	0,000393
RuneScape	92	146	238	49	0,000392
OM NOM NOM NOM	230	34	264	22	0,000388
Friends	242	36	278	8	0,000386
Bukkake	257	38	295	36	0,000386
12-year-old girl	275	75	350	16	0,000385
Oxymoron	237	76	313	35	0,000385
Mary Sue	537	160	697	21	0,000384
Fake News	192	191	383	19	0,000383
Nice try	330	29	359	21	0,000382
OhInternet	195	67	262	52	0,000381
People	211	78	289	13	0,00038
Mr. Hands	181	39	220	31	0,000379
Hookers and Blow	282	53	335	14	0,000377
Scene	209	166	375	12	0,000375
Pussybitch	203	59	262	19	0,000375
Stick It In Her Pooper	106	21	127	39	0,000373
Weev	193	88	281	41	0,000373
Cosplay	328	109	437	28	0,000373
English Scum	278	97	375	42	0,000372
Moonspeak	236	35	271	28	0,000371
Chan	215	152	367	9	0,000369
Family Guy	210	141	351	34	0,000369
You're/Your	93	27	120	3	0,000369
Neckbeard	305	68	373	7	0,000369
Hugbox	343	29	372	7	0,000368
Internet lawsuit	363	40	403	48	0,000367
NAMBLA	186	73	259	43	0,000365
Original Content	250	93	343	9	0,000364
Homophobia	138	83	221	40	0,000364
Injuns	211	146	357	35	0,00036
Lame	285	16	301	40	0,00036
IMMA CHARGIN MAH LAZER	292	53	345	9	0,000359
Ball	301	33	334	63	0,000359
Star Trek	220	127	347	33	0,000357
Man The Harpoons	217	26	243	52	0,000357
Attention	144	31	175	8	0,000356
Cult	236	89	325	26	0,000356
Microsoft	221	18	239	10	0,000355
Sarah Palin	157	177	334	14	0,000355
Raid	255	116	371	26	0,000354
Diabeetus	183	90	273	52	0,000351
YTMND	156	35	191	9	0,00035
Chris Crocker	185	100	285	40	0,000349
The Simpsons	168	98	266	34	0,000349
Skript kiddie	284	56	340	10	0,000348
Shemale	246	75	321	63	0,000348
Orgasm	180	6	186	39	0,000346
G.R.I.D.S.	108	37	145	40	0,000345
HA HA HA, OH WOW	316	17	333	7	0,000344
Paris Hilton	177	83	260	36	0,000342
Bubba	200	36	236	39	0,000342
Ftw	80	29	109	14	0,000342
Evil-unveiled.com/BoyBliss	49	13	62	43	0,000342
Mario	233	225	458	49	0,000341
Boxxy	157	152	309	9	0,00034
Dickgirl	194	36	230	28	0,00034
Ku Klux Klan	270	90	360	35	0,000338
Femitheist	5	8	13	19	0,000338
Zerg Rush	155	40	195	49	0,000336
Troll's Remorse	301	36	337	41	0,000334
Theft	272	33	305	35	0,000334
Epic Fail Guy	192	59	251	9	0,000333
Circle jerk	354	38	392	61	0,000333
Habbo Hotel	168	114	282	9	0,000333
Batman	237	161	398	34	0,000333
Forever Alone	295	48	343	7	0,00033
Bureaucratic Fuck	208	148	356	2	0,00033
Hott	177	42	219	2	0,000329
Waaaambulance	353	35	388	5	0,000329
Vorarephilia	240	69	309	31	0,000328
Jenkem	229	42	271	35	0,000327
California	259	100	359	35	0,000325
Ann Coulter	128	50	178	14	0,000325
Sweden	178	131	309	37	0,000324
I See What You Did There	159	4	163	17	0,000324
Alien	152	37	189	17	0,000324
Ireland	203	148	351	37	0,000323
Best Korea	203	151	354	37	0,000321
2010	285	175	460	41	0,000321
Los Angeles	200	73	273	35	0,000319
Welfare	231	75	306	35	0,000318
Art	261	62	323	31	0,000316
LJDrama	93	21	114	8	0,000316
Earth	163	47	210	46	0,000315
Rickroll	233	75	308	9	0,000315
List of sex moves	185	111	296	39	0,000314
Chuck Norris	126	59	185	13	0,000314
Sheneequa	131	42	173	35	0,000314
Vampire	192	166	358	27	0,000314
Orgy	272	32	304	36	0,000313
Gentlemen	142	102	244	9	0,000313
Zombie	225	53	278	49	0,000313
Yaoi	229	66	295	28	0,000312
E-lawyer	266	27	293	8	0,000312
Intellectual Checkmate	121	125	246	48	0,000311
Lollercaust	146	21	167	48	0,000311
Never forget	119	17	136	37	0,00031
Denial of Service	225	39	264	10	0,000309
FurAffinity	247	189	436	31	0,000308
Osama bin Laden	173	93	266	37	0,000308
Animal	113	73	186	25	0,000308
No girls on the internet	155	47	202	4	0,000307
Bantown	139	83	222	41	0,000306
Genital Herpes	133	37	170	36	0,000306
Heterosexual	148	43	191	40	0,000305
Tay Zonday	153	88	241	9	0,000305
EBaumsworld.com	194	106	300	26	0,000304
Anthony 'A-Log' LoGatto	104	330	434	7	0,000304
Mediacrat	89	100	189	8	0,000303
No life	353	40	393	60	0,000302
Life	138	244	382	46	0,000302
INTERNET HATE MACHINE	297	34	331	26	0,000302
Longcat	171	62	233	25	0,000301
2girls1cup	162	40	202	22	0,000301
Psychopath	265	67	332	30	0,0003
Fandom	283	87	370	21	0,0003
Falcon Punch	147	32	179	36	0,0003
House	155	148	303	9	0,000299
Iran	152	130	282	37	0,000299
IPhone	110	91	201	10	0,000298
Dog	204	66	270	25	0,000297
Veteran	219	96	315	9	0,000297
419 Nigerian Email Scams	137	43	180	64	0,000296
Naruto	240	222	462	28	0,000296
Trollface	174	91	265	9	0,000295
Advice Dog	153	64	217	9	0,000295
Bill Clinton	120	73	193	19	0,000295
AOL	130	49	179	10	0,000295
MeganSpeaks	54	215	269	36	0,000294
Logic	187	126	313	46	0,000293
Fursuit	192	47	239	31	0,000293
Buy A Dog	202	70	272	26	0,000292
Juggalo	160	195	355	51	0,000292
Guido	208	82	290	57	0,000291
So cash	165	91	256	9	0,00029
H8	334	23	357	21	0,00029
Ginger	218	92	310	42	0,00029
Love	245	96	341	50	0,000288
Glenn Beck	120	125	245	14	0,000288
Mundane	218	24	242	31	0,000288
Chav	172	121	293	42	0,000287
Dragon Ball Z	206	162	368	28	0,000287
Asia	136	113	249	37	0,000287
Greece	133	132	265	37	0,000286
War	198	94	292	37	0,000286
Yes	267	12	279	44	0,000286
Pope	112	57	169	46	0,000286
Fat Girl Angle Shot	159	40	199	52	0,000284
AOL Instant Messenger	120	75	195	8	0,000283
Britney Spears	149	76	225	36	0,000283
Role-playing	265	52	317	31	0,000283
Oprah Winfrey	124	67	191	35	0,000282
Gamers	187	76	263	49	0,000281
Fursecution	183	118	301	31	0,000281
Shitting Dick Nipples	129	15	144	31	0,000279
I'm rich and I'm beautiful	167	41	208	8	0,000279
Crapflood	197	43	240	10	0,000279
Insane Clown Posse	120	117	237	51	0,000278
Condom	131	57	188	36	0,000278
Evolution	150	88	238	46	0,000278
Pepe	125	134	259	19	0,000278
Time Cube	129	50	179	46	0,000278
Godwin's Law	142	48	190	41	0,000277
High Score	239	281	520	58	0,000277
X is not your personal army	310	41	351	26	0,000277
Texas	220	126	346	35	0,000276
Placentafag	178	138	316	26	0,000275
Kawaii	222	55	277	28	0,000275
In the kitchen	226	59	285	39	0,000274
Emoticon	114	126	240	54	0,000274
Kewlies	158	39	197	13	0,000272
Vegetarian	170	142	312	25	0,000271
Ron Paul	160	215	375	14	0,00027
Shock Site	107	82	189	6	0,00027
Food	151	58	209	52	0,000269
2017	214	223	437	19	0,000269
Spain	166	136	302	37	0,000269
Censorship	194	61	255	2	0,000268
Yahoo!	105	66	171	13	0,000268
MONGO	118	60	178	2	0,000267
Vandal	220	23	243	2	0,000266
Verbose Thread	76	13	89	9	0,000266
Pervert	216	20	236	53	0,000265
Terrorism	183	64	247	37	0,000264
The Fresh Prince of Bel-Air	196	25	221	9	0,000264
HACKERS ON STEROIDS	165	53	218	26	0,000262
Usenet	101	91	192	41	0,000262
Fuck you, I'm a dragon!	225	43	268	31	0,000262
Why do you hate America?	115	43	158	14	0,000261
Girlfriend	184	67	251	36	0,00026
CIA	143	41	184	37	0,00026
Geek	156	32	188	10	0,00026
Darth Cheney	99	35	134	14	0,00026
Pregnant	175	81	256	36	0,000259
Bear	112	68	180	40	0,000259
Computer	169	77	246	10	0,000258
The Great Black Dick Hoax	149	55	204	63	0,000258
Hepkitten	68	18	86	41	0,000258
OJ Simpson	102	73	175	35	0,000257
Car	106	154	260	37	0,000257
Nintendo	229	58	287	49	0,000256
Pirate	197	89	286	10	0,000256
7chan	162	88	250	9	0,000256
GamerGate	228	147	375	19	0,000256
PETA	160	119	279	25	0,000255
Christmas	129	91	220	46	0,000255
Vietnam	109	76	185	37	0,000254
Circumcision	114	112	226	17	0,000254
Article	124	7	131	2	0,000254
Pun	104	4	108	7	0,000253
Meatspin.com	129	41	170	6	0,000253
Fundamentalist	160	90	250	46	0,000253
Snapesnogger	204	155	359	21	0,000253
Internet Law	210	127	337	41	0,000253
Internet drama	122	30	152	8	0,000252
Daddy	170	81	251	36	0,000252
Anonymous pussy	42	20	62	8	0,000252
Jessi Slaughter	176	181	357	12	0,000251
Transformers	128	155	283	34	0,000251
Wiki	146	99	245	2	0,000251
Transvestite	181	34	215	63	0,00025
MrRepzion	25	100	125	19	0,00025
2016	240	136	376	19	0,000249
Evil-unveiled.com/BoyMoment	59	3	62	43	0,000249
Manchild	290	133	423	7	0,000247
San Francisco	141	97	238	11	0,000247
Schizophrenia	192	37	229	30	0,000247
Cool story bro	202	48	250	15	0,000246
Hal Turner	111	202	313	26	0,000246
Amphetamines	215	68	283	35	0,000246
Dubious disclaimer	66	33	99	8	0,000245
Cybersex	216	37	253	31	0,000245
Government	161	58	219	37	0,000245
9gag	77	112	189	9	0,000244
Cthulhu	115	50	165	46	0,000243
SpongeBob Squarepants	113	95	208	34	0,000243
Statistics	103	40	143	8	0,000243
Bill O'Reilly	111	98	209	14	0,000243
Lonely	209	52	261	28	0,000242
Linkin Park	128	105	233	12	0,000242
E-penis	243	36	279	16	0,000242
BILLY MAYS	116	100	216	9	0,000241
LifeInATent	76	156	232	36	0,000241
Libertarianism	163	178	341	14	0,000241
Lurker	118	38	156	9	0,000241
Baby	140	80	220	1	0,00024
Portal	142	115	257	49	0,000239
Drunk	237	52	289	37	0,000239
Fursona	279	58	337	31	0,000239
Sauce	102	26	128	9	0,000238
LOLDONGS	86	34	120	54	0,000238
Plastic crap	163	42	205	7	0,000238
The Matrix	147	63	210	17	0,000237
X? In My Y?	111	46	157	9	0,000237
Thin Skin	39	74	113	7	0,000237
Partyvan	219	7	226	26	0,000236
Ghetto	190	23	213	35	0,000236
1980s	156	79	235	12	0,000236
Opioids	140	77	217	12	0,000236
Midget	180	37	217	63	0,000236
Otaku	179	41	220	28	0,000235
UrbanDictionary.com	66	55	121	3	0,000235
Xbox	199	51	250	49	0,000234
X Y is X	155	43	198	9	0,000234
Socialist	155	55	210	14	0,000234
Wal-Mart	176	93	269	35	0,000234
Wicca	183	118	301	27	0,000233
99,90%	78	20	98	28	0,000233
Big Brother	133	72	205	37	0,000233
2014	209	87	296	19	0,000233
Futurama	72	99	171	34	0,000233
Shameless self promotion	153	52	205	48	0,000233
Korea	143	49	192	49	0,000233
Technical virgin	39	29	68	12	0,000233
Party Hard	156	47	203	9	0,000232
A frank discussion of mental illness	140	58	198	58	0,000232
Attention Deficit Hyperactivity Disorder	189	16	205	34	0,000232
Ripper	101	34	135	1	0,000232
Doctor Who	132	127	259	33	0,000231
Evil-unveiled.com/Rookiee	29	3	32	43	0,000231
North Britain	125	137	262	37	0,00023
Derp	195	27	222	61	0,000229
LJ Abuse	73	23	96	8	0,000229
In Soviet Russia...	128	98	226	37	0,000229
Mega ultra super genius	226	40	266	11	0,000229
Miley Cyrus	98	118	216	36	0,000228
Nobody	208	7	215	15	0,000227
Newgrounds	157	13	170	4	0,000227
EBay	150	61	211	8	0,000226
This Looks Shopped	124	11	135	9	0,000226
Mad Mel	90	65	155	37	0,000226
Baleet	292	7	299	24	0,000226
Craigslist	112	63	175	41	0,000226
Centipede filled vagina	112	43	155	39	0,000226
TV Tropes	117	174	291	2	0,000225
Community	116	9	125	8	0,000225
Job	148	113	261	35	0,000225
MILF	179	50	229	36	0,000224
Genocide	117	71	188	37	0,000224
Cripples	177	39	216	38	0,000224
Trolls Trolling Trolls	115	76	191	41	0,000224
DMCA	158	59	217	48	0,000223
Why So Serious?	150	106	256	9	0,000222
My Chemical Romance	114	102	216	12	0,000222
SysOp	142	76	218	2	0,000222
Creepypasta	141	50	191	22	0,000222
Kill Yourself	122	5	127	19	0,000222
Duuuuuuuuuuuuuuuuuuuuhhh	178	25	203	23	0,000222
Florida	179	92	271	35	0,00022
Nawlins	127	68	195	35	0,00022
Philosophy	74	61	135	46	0,00022
Dungeons & Dragons	136	200	336	15	0,00022
Bitches Don't Know	105	178	283	9	0,000219
Islamic State of Iraq and Syria	136	97	233	37	0,000219
Professional Wrestling	158	206	364	15	0,000219
Minecraft	148	251	399	20	0,000219
Xenu	101	31	132	26	0,000219
Brian Peppers	121	42	163	56	0,000219
Dane Cook	60	71	131	17	0,000218
Albert Einstein	46	47	93	46	0,000217
All Your Base Are Belong To Us	147	54	201	37	0,000216
Cuckoldry	234	59	293	19	0,000216
Demotivators	65	55	120	9	0,000215
Kanye West	98	11	109	12	0,000215
Hardcore	142	8	150	12	0,000215
Hot Topic	140	97	237	12	0,000215
Lollercoaster	66	45	111	48	0,000215
Patrick Hamm and Lena Chen	35	87	122	37	0,000215
Feminist Frequency	192	150	342	19	0,000214
The Netherlands	98	21	119	37	0,000214
Ad hominem	84	21	105	46	0,000214
Poetry	87	78	165	12	0,000214
Fifty Hitler post	75	50	125	8	0,000214
HNNNNNNGGGGG	116	50	166	9	0,000213
80-year-old Chinese man in panties	76	27	103	28	0,000212
Second Life	156	79	235	31	0,000212
Eminem	86	74	160	12	0,000212
Liberal guilt	67	42	109	35	0,000211
Chat	81	38	119	3	0,000211
George Bush doesn't care about black people	73	67	140	35	0,000211
Advertising	114	61	175	17	0,000211
ASCII	75	8	83	41	0,00021
Beastiality	130	1	131	31	0,00021
R9gay	93	115	208	9	0,00021
Girl on the Internet Syndrome	199	124	323	7	0,00021
Raver	126	137	263	12	0,00021
Girl	108	27	135	12	0,000209
Kurt Cobain	118	43	161	12	0,000209
Afghanistan	111	57	168	37	0,000209
LINK MAH BOIIIII	121	139	260	9	0,000209
Allah	107	72	179	37	0,000209
Babyfur	166	66	232	31	0,000209
Final Fantasy VII	112	142	254	29	0,000208
Politically Correct	105	58	163	14	0,000208
George Bush	107	5	112	14	0,000208
Evil-unveiled.com/GirlLove Garden	18	10	28	43	0,000208
Evil-unveiled.com/Pedologues	29	2	31	43	0,000208
OldDirtyBtard	83	66	149	26	0,000207
Quasidan	34	10	44	8	0,000207
Is This Battletoads	153	88	241	49	0,000206
LittleCloud	64	130	194	21	0,000206
ENGLISH MOTHERFUCKER DO YOU SPEAK IT	152	94	246	37	0,000206
Mitchell Henderson	132	92	224	58	0,000205
Instagram	90	29	119	59	0,000205
Fedora	111	76	187	19	0,000205
Random	112	5	117	9	0,000205
Call of Duty	178	53	231	49	0,000204
Journal	84	28	112	8	0,000204
Turkey	108	173	281	37	0,000204
Madeleine McCann	101	155	256	17	0,000203
Mark Foley	71	57	128	14	0,000203
Extreme	95	72	167	39	0,000203
Death Note	122	108	230	28	0,000203
Winrar	138	22	160	10	0,000203
Flame	165	18	183	21	0,000203
Doopie DoOver	70	141	211	53	0,000202
Zoe Quinn	160	207	367	19	0,000202
Pig	145	55	200	35	0,000202
Lady Gaga	128	154	282	36	0,000202
Halo	193	77	270	49	0,000201
Satanist	118	252	370	46	0,000201
Evil-unveiled.com/Visions of Alice	46	8	54	43	0,000201
Angst	161	49	210	12	0,0002
LURK MOAR	96	8	104	9	0,0002
Infantilism	127	67	194	7	0,0002
Expert	84	24	108	13	0,000199
Castration	116	55	171	63	0,000199
Sandy Hook Elementary Massacre	89	160	249	58	0,000199
Dong	85	8	93	37	0,000199
Fleshlight	98	26	124	26	0,000198
Cuntpaste	53	5	58	49	0,000198
RTFM	37	6	43	10	0,000198
Literally	122	28	150	19	0,000197
Punk	110	118	228	12	0,000197
MMORPG	165	139	304	49	0,000196
I accidentally X	128	19	147	9	0,000196
Angry Homo Kid	67	112	179	40	0,000196
Roman Shower	78	25	103	39	0,000196
Go fuck yourself	42	6	48	49	0,000196
Evil-unveiled.com/Boylandonline.com	42	11	53	43	0,000196
Celebrity	140	36	176	36	0,000195
Poseur	153	26	179	12	0,000195
Ruination	149	41	190	26	0,000195
Michael Moore	68	76	144	14	0,000195
Jonas Brothers	87	78	165	12	0,000194
Pedophilia apologia	20	27	47	19	0,000194
Conservapedia	72	154	226	46	0,000194
Brazil	112	143	255	35	0,000194
Real World	49	26	75	3	0,000194
Grawp	98	236	334	2	0,000193
Dat Ass	121	40	161	49	0,000193
Pol/	142	100	242	19	0,000193
Oh noes	182	48	230	3	0,000192
Saddam Hussein	77	76	153	37	0,000192
Cunnilingus	80	37	117	36	0,000192
Mathematics	78	83	161	11	0,000191
Chris Forcand	71	62	133	26	0,000191
The Colbert Report	113	174	287	14	0,000191
Depression	149	39	188	13	0,000191
GET OUT	57	9	66	33	0,000191
Nothing	192	2	194	13	0,00019
Lolrus	33	29	62	48	0,00019
Detroit	122	148	270	35	0,000189
Disease	79	32	111	13	0,000189
Bill Gates	118	98	216	10	0,000189
420chan	101	160	261	9	0,000188
Disorder	82	71	153	13	0,000188
Child abuse	128	37	165	13	0,000188
Ted Stevens	72	85	157	53	0,000187
Plagiarism	180	25	205	61	0,000187
Internet court	93	5	98	2	0,000187
ZOMG	119	22	141	48	0,000186
Chris Benoit	96	117	213	0	0,000186
Mantrain	113	29	142	40	0,000186
DOUBLE NIGGER	126	58	184	35	0,000186
Period	141	47	188	39	0,000186
Fisting	97	40	137	40	0,000185
Art School	113	136	249	12	0,000185
Detective	142	24	166	8	0,000185
Marriage	128	71	199	36	0,000185
ROFLCOPTER	47	33	80	48	0,000185
JESUS CHRIST IT'S A LION GET IN THE CAR!	97	34	131	31	0,000184
Sammich	92	32	124	39	0,000184
MTV	88	57	145	12	0,000183
U MAD	169	70	239	44	0,000183
Roman Empire	61	120	181	37	0,000183
Dinosaur	65	61	126	46	0,000183
Meek Mill	16	51	67	35	0,000183
Steve Jobs	107	90	197	10	0,000182
Aboriginal	95	66	161	35	0,000182
Electric Boogaloo	165	53	218	49	0,000182
Viking	67	66	133	37	0,000182
No one likes you	68	84	152	13	0,000182
Caturday	100	42	142	25	0,000181
Gb2	41	21	62	9	0,000181
FUCK YEAH SEAKING	107	60	167	9	0,000181
Adult Swim	101	150	251	34	0,00018
BitTorrent	114	111	225	10	0,00018
Anarchy	145	93	238	14	0,00018
Gangbang	128	52	180	36	0,000179
AnonTalk	85	151	236	9	0,000179
Perverted-Justice	37	57	94	43	0,000179
Eating disorder	82	36	118	52	0,000179
Drama whore	147	21	168	8	0,000179
Jack Thompson	84	55	139	58	0,000179
Rofl	82	20	102	26	0,000178
The Great Habbo Raid of July 2006	52	83	135	9	0,000178
Aspierations	77	89	166	7	0,000178
Rules of the Internet	120	52	172	9	0,000177
Torture	109	42	151	37	0,000177
Email	92	51	143	64	0,000177
Memefag	36	165	201	9	0,000177
IPod	96	95	191	10	0,000177
Macro	40	6	46	9	0,000177
Counter-Strike	121	139	260	49	0,000176
Tracing	206	117	323	21	0,000176
Lord of the Rings	141	52	193	46	0,000176
John F. Kennedy	91	68	159	17	0,000176
Pakis	113	81	194	37	0,000176
Magic	126	75	201	27	0,000176
Ebonics	94	32	126	35	0,000176
Girl Drama	39	27	66	52	0,000176
Evil-unveiled.com/Newgon.com	19	3	22	43	0,000176
Palestine	93	121	214	37	0,000175
Ronald Reagan	97	66	163	14	0,000175
WikiLeaks	104	158	262	19	0,000175
Superman	93	69	162	34	0,000175
Finland	86	102	188	37	0,000175
Alcoholic	169	33	202	36	0,000175
School Shooting	122	211	333	58	0,000174
Narcissistic personality disorder	135	72	207	7	0,000174
Anger	83	91	174	17	0,000173
Military	85	98	183	37	0,000173
Molest	127	15	142	53	0,000173
StarCraft	84	108	192	49	0,000173
Swirl Face	50	69	119	39	0,000173
Canadia	106	2	108	37	0,000173
Opinion	77	42	119	19	0,000172
Mujahideen Video	129	46	175	37	0,000172
Tripcode	78	18	96	9	0,000172
Richard Dawkins	101	143	244	46	0,000171
12chan	71	43	114	9	0,000171
I/	100	85	185	9	0,000171
Slashdot	69	83	152	10	0,000171
Nice Guys	146	64	210	36	0,000171
How Do I Shot Web?	145	63	208	9	0,00017
Muhammad Cartoons	88	113	201	37	0,000169
Virus	100	37	137	10	0,000169
Language	33	41	74	37	0,000169
Ninja	131	71	202	49	0,000168
My Immortal	125	160	285	12	0,000168
Gawker Media	105	189	294	19	0,000168
Army	117	65	182	37	0,000168
Copyright	132	36	168	48	0,000167
Vomit	133	39	172	6	0,000167
Dylan Thomas	25	32	57	43	0,000167
Homeless	151	30	181	35	0,000167
Motherless.com	22	84	106	39	0,000167
And nothing of value was lost	138	17	155	1	0,000166
Never	130	19	149	13	0,000166
Freedom	82	31	113	37	0,000166
PlayStation	152	74	226	49	0,000166
Weegee	103	81	184	9	0,000166
Ceiling Cat	63	40	103	25	0,000166
Omegle	31	76	107	18	0,000166
Pegging	59	25	84	40	0,000165
Neutral point of view	51	16	67	2	0,000165
Basement	148	6	154	13	0,000164
Wolfaboo	93	160	253	31	0,000164
Time	42	17	59	53	0,000164
NeoGAF	59	125	184	19	0,000164
Book	79	42	121	46	0,000164
Original Poster	16	46	62	9	0,000164
Prince Jeremy	76	117	193	31	0,000163
Gypsies	82	42	124	37	0,000163
Rosie O'Donnell	54	39	93	19	0,000163
Virginia Tech Massacre	113	182	295	58	0,000162
JoshU2uber	31	126	157	40	0,000162
Bad Vlad	113	125	238	37	0,000162
404 Girl	36	40	76	9	0,000162
You Win the Prize	76	4	80	58	0,000162
Awwright	96	8	104	31	0,000162
Denmark	64	35	99	37	0,000162
Gaston	29	73	102	9	0,000161
Obsessive Compulsive Disorder	121	26	147	7	0,000161
Hot	125	6	131	52	0,000161
PayPal	84	40	124	8	0,000161
Image	85	29	114	9	0,000161
Legend of Zelda	115	127	242	49	0,00016
Sheep	130	22	152	61	0,00016
BitingBeaver	81	102	183	26	0,00016
Elliot Rodger	110	92	202	58	0,00016
Brianna Wu	99	140	239	19	0,00016
Milhouse is not a meme	94	26	120	9	0,00016
Copypasta/Archive 8	16	12	28	9	0,00016
Global Warming	103	86	189	46	0,000159
History	82	33	115	37	0,000159
Metal (music)	107	167	274	12	0,000159
Slowpoke	110	26	136	9	0,000159
Oil	66	37	103	37	0,000159
Catchphrase	42	51	93	8	0,000159
Evil-unveiled.com/Little Boy Lover Forum	17	7	24	43	0,000159
Heath Ledger	71	83	154	40	0,000158
LJ user	70	14	84	8	0,000158
Rimjob	68	15	83	40	0,000158
Goodnight Sweet Prince	105	28	133	9	0,000158
Pulse Nightclub Massacre	55	101	156	58	0,000157
Serial Killers	80	100	180	22	0,000157
Cho Seung-Hui	132	64	196	58	0,000157
2018	127	67	194	19	0,000157
Ohio	94	97	191	35	0,000157
Hero	121	77	198	34	0,000157
Headshot	100	29	129	58	0,000157
Suck	87	2	89	32	0,000157
Ohbutyouwillpet	59	39	98	39	0,000156
Desperate	153	103	256	40	0,000156
Bill Nye	53	89	142	19	0,000156
Swap.avi	43	20	63	22	0,000156
Category:People	104	0	104	32	0,000156
L. Ron Hubbard	96	114	210	26	0,000156
Too cool for the Internet	17	67	84	51	0,000156
1990s	137	76	213	58	0,000155
Put Shoe On Head	70	58	128	8	0,000155
Ass Rape	52	12	64	39	0,000155
Gang	109	40	149	35	0,000155
Soccer	75	127	202	37	0,000155
Concerned Mother	117	134	251	58	0,000155
Ignored	62	25	87	27	0,000154
Sceptre	82	174	256	2	0,000154
E-Psychiatrist	64	76	140	26	0,000154
Latin	52	89	141	37	0,000154
Tim Sharky	139	17	156	36	0,000154
Evil-unveiled.com/Epifora	13	2	15	43	0,000154
2015	183	100	283	19	0,000153
Erectile dysfunction	62	24	86	55	0,000153
Heather Lind	14	37	51	39	0,000153
Hypnotoad	40	13	53	9	0,000152
Handegg	89	39	128	35	0,000152
Steve Irwin	81	81	162	3	0,000152
WHEN I WAS	78	111	189	9	0,000152
Hank Hill	69	85	154	34	0,000152
Perez Hilton	68	113	181	0	0,000152
Yu-Gi-Oh!	103	116	219	28	0,000151
Stoner	95	94	189	34	0,000151
Norway	80	75	155	37	0,000151
Wales	70	97	167	37	0,000151
Men's Rights Activist	63	96	159	19	0,000151
John McCain	88	111	199	14	0,00015
Skill	97	9	106	10	0,00015
Wikipedia Porn	38	33	71	2	0,00015
Super Smash Bros	114	284	398	49	0,00015
Bailout Plan	72	95	167	17	0,00015
Kimmo Johan Alm	66	74	140	9	0,00015
Frienditto	25	30	55	8	0,00015
Nope.avi	121	4	125	49	0,000149
Prostitot	85	22	107	36	0,000149
Candlejack	55	17	72	9	0,000149
Mai Waifu	136	25	161	28	0,000149
Pedo Baiting	33	47	80	53	0,000149
Bipolar Disorder	139	83	222	13	0,000149
Lena Dunham	49	200	249	19	0,000149
Face-painter	42	82	124	20	0,000149
Didaskalos	15	57	72	43	0,000149
Evil-unveiled.com/Sure Quality Radio	23	20	43	43	0,000149
Metallica	65	109	174	12	0,000148
Animal abuse	92	96	188	25	0,000148
Sup Dawg	107	186	293	9	0,000148
I am disappoint	131	51	182	9	0,000148
Occupy Wall Street	72	82	154	14	0,000148
Mozilla Firefox	87	105	192	10	0,000148
Thailand	53	51	104	39	0,000148
Breeder	62	40	102	40	0,000148
Lollerskates	22	11	33	48	0,000148
Cooldude	92	29	121	57	0,000147
Adam Lanza	87	113	200	58	0,000147
White guilt	110	56	166	35	0,000147
President	93	88	181	14	0,000147
How is babby formed?	91	31	122	36	0,000147
Sell Out	111	74	185	12	0,000147
HTML	60	25	85	10	0,000147
Last Measure	97	37	134	41	0,000147
Thread	48	46	94	9	0,000147
Internet police	112	48	160	41	0,000147
LJ TOS	52	10	62	8	0,000147
Lmaonade	19	11	30	48	0,000147
Steamloller	17	11	28	48	0,000147
Brb, soup	62	51	113	9	0,000146
Patriotic Nigras	73	62	135	31	0,000146
Shitty art	188	62	250	21	0,000146
1guy1jar	76	36	112	6	0,000146
Alex Jones	125	147	272	17	0,000146
Furry art	87	138	225	31	0,000146
CNN	87	26	113	19	0,000146
Nerd Rage	161	65	226	26	0,000146
Yahoo! Answers	64	73	137	38	0,000146
Amazon	87	43	130	53	0,000146
Fiction	49	14	63	46	0,000146
Social networking sites	106	37	143	19	0,000146
Lindsay Lohan	56	64	120	36	0,000145
Paul "Fetch" Carnes	77	31	108	48	0,000145
VenomFangX	68	87	155	46	0,000145
Torpark	71	94	165	10	0,000145
Flash	123	70	193	4	0,000145
Webcomic	136	100	236	28	0,000145
TL;DW	119	12	131	48	0,000145
Purelily	38	43	81	46	0,000145
Lolcano	32	11	43	48	0,000145
Lmaowl	18	12	30	48	0,000145
Poeticirony	62	35	97	31	0,000144
Sage	100	24	124	9	0,000144
Steroids	99	6	105	49	0,000144
Gullible	93	10	103	36	0,000144
Giant dildo of death	61	16	77	31	0,000144
Buddha	80	91	171	46	0,000144
I have a 140 IQ	40	27	67	11	0,000144
Evil-unveiled.com/Christian Boylove Forum	23	3	26	43	0,000144
Not racist	80	44	124	35	0,000143
Spellcheck	83	42	125	3	0,000143
New Zealand	78	70	148	59	0,000143
Photomanip	64	11	75	52	0,000143
GIF	68	62	130	9	0,000143
Asexuality	54	80	134	40	0,000143
Fire	75	63	138	29	0,000143
Convention	99	46	145	31	0,000143
Reaction Face	57	21	78	9	0,000142
Onideus Mad Hatter	56	182	238	52	0,000142
Fucking Magnets	99	34	133	51	0,000142
AnonOps	37	43	80	10	0,000142
Touhou	64	113	177	28	0,000142
Meh	51	18	69	3	0,000142
Rainbow Stalin	92	8	100	37	0,000142
Lmaonaise	18	13	31	48	0,000142
YouTube Poop	100	96	196	34	0,000141
Robot	142	24	166	49	0,000141
No Homo	61	32	93	40	0,000141
Black Metal	76	100	176	12	0,000141
Bike	108	43	151	35	0,000141
E-psychiatry	75	19	94	26	0,000141
LoveShy	61	63	124	7	0,000141
Sean Hannity	29	30	59	14	0,000141
Hello Kitty	45	50	95	28	0,000141
Zippocat	67	32	99	25	0,00014
Soulja Boy	69	76	145	12	0,00014
Xbox 360	118	165	283	49	0,00014
Catnarok	76	30	106	25	0,00014
Robotnik	69	89	158	63	0,00014
Evil-unveiled.com/Montreal Ganymede Collective	15	13	28	43	0,00014
BBS	43	14	57	55	0,000139
Goofy Time	78	26	104	9	0,000139
Sacha Baron Cohen	86	65	151	41	0,000139
Rick Santorum	84	65	149	14	0,000139
Samefag	113	25	138	9	0,000139
Bayeux Tapestry	47	60	107	9	0,000139
Camping	22	41	63	49	0,000139
Elvis Presley	72	78	150	35	0,000139
Strikethrough	24	6	30	34	0,000139
Liberal media	27	93	120	19	0,000139
Butterfly Kisses	27	16	43	43	0,000139
Dragon	96	98	194	31	0,000138
Steam	118	54	172	49	0,000138
Serbia	78	40	118	37	0,000138
Confederate States of America	88	135	223	35	0,000138
Metal Gear Solid	112	148	260	49	0,000138
Agnosticism	35	39	74	46	0,000138
Shock Image	39	43	82	6	0,000138
Defamation	93	32	125	8	0,000138
Goggles	57	22	79	22	0,000138
Tony Abbott	8	61	69	14	0,000138
Evil-unveiled.com/BoyTales	8	3	11	43	0,000138
Lols-royce	15	11	26	48	0,000138
Retro	133	45	178	61	0,000137
Epilepsy	101	8	109	12	0,000137
Bitches and whores	49	77	126	36	0,000137
Philippines	78	141	219	35	0,000137
Tom Preston	116	146	262	19	0,000137
Barrel Roll	93	53	146	9	0,000137
Less than three	53	28	81	32	0,000137
You don't have any friends	151	49	200	8	0,000137
Violence	104	46	150	37	0,000137
Tori Sue Heck	41	66	107	21	0,000137
Reptoid	51	42	93	17	0,000137
Tara Strong	48	143	191	7	0,000137
Jeff Weise	50	152	202	58	0,000136
I GOT NORTON!	48	25	73	10	0,000136
Evil-unveiled.com/MrDouble.com	8	2	10	43	0,000136
Spax3	71	51	122	61	0,000135
Friends only	78	15	93	8	0,000135
Football	74	12	86	35	0,000135
Evil-unveiled.com/Steven Jones	12	3	15	43	0,000135
LSD	125	38	163	17	0,000134
Alex Wuori	56	66	122	26	0,000134
Negress	100	55	155	35	0,000134
W. T. Snacks	54	29	83	9	0,000134
InterWeb	86	10	96	32	0,000134
Edgy	190	111	301	7	0,000134
Allege	99	32	131	8	0,000134
Bernie Madoff	37	48	85	17	0,000134
Evil-unveiled.com/BoyLinks	9	1	10	43	0,000134
UNIX	53	50	103	10	0,000133
Bullying	105	116	221	13	0,000133
Friends list	48	11	59	8	0,000133
Indie	108	125	233	12	0,000133
Teruchan	57	114	171	28	0,000133
Special Snowflake Syndrome	113	58	171	7	0,000133
Proxy	94	22	116	2	0,000133
Willy on Wheels (on Wheels)	52	20	72	2	0,000133
Gay Rape	15	75	90	39	0,000133
Straight Edge	51	68	119	12	0,000132
3Guys1Hammer	69	43	112	22	0,000132
SheezyArt	58	59	117	21	0,000132
Megan Meier	65	105	170	41	0,000132
Gordon the Pringles Giraffe	33	74	107	9	0,000132
Armenians	56	75	131	37	0,000132
Fox	55	43	98	31	0,000132
Evil-unveiled.com/LifeLine	14	7	21	43	0,000132
Pedopals	14	24	38	53	0,000132
Happy Negro	53	30	83	9	0,000131
That Fucking Cat	85	52	137	9	0,000131
Londonistan	113	105	218	37	0,000131
Website	94	5	99	2	0,000131
Unemployment	126	38	164	35	0,000131
Al Qaeda	75	34	109	37	0,000131
WoW	127	5	132	49	0,000131
Proposition 8	31	84	115	14	0,000131
Trigger	123	32	155	19	0,000131
Arnold Schwarzenegger	104	68	172	33	0,000131
Kool-Aid	67	24	91	35	0,000131
Rush Limbaugh	82	124	206	14	0,000131
Evil-unveiled.com/John Melanson	6	7	13	43	0,000131
Sharking	19	14	33	39	0,00013
BFF	145	6	151	21	0,00013
Drama queen	98	51	149	8	0,00013
Completely irrelevant history	33	19	52	2	0,00013
Doom	103	120	223	49	0,000129
Belgium	46	94	140	37	0,000129
Digimon	86	219	305	28	0,000129
The Unknown Autobot	45	223	268	7	0,000129
Fat Whore	52	22	74	52	0,000129
Final Fantasy	139	24	163	49	0,000129
Airplane	49	182	231	35	0,000129
Zeta Toy	45	34	79	31	0,000129
Chin-chan	49	65	114	9	0,000128
Robert Levin	49	105	154	41	0,000128
PlayStation 3	115	89	204	49	0,000128
Copyright Infringement	90	36	126	61	0,000128
Creationist	112	86	198	46	0,000128
Stripper	94	38	132	36	0,000128
Swearing	54	68	122	34	0,000128
New Jersey	107	77	184	35	0,000127
Sport	74	47	121	35	0,000127
Know Your Meme	73	119	192	9	0,000127
A Plus	44	26	70	8	0,000127
Stickam	93	124	217	48	0,000127
YHBT	114	12	126	41	0,000127
Actor	55	51	106	36	0,000127
SlimVirgin	68	55	123	2	0,000127
Inflation art	109	89	198	31	0,000127
My Tiny Dick	56	43	99	63	0,000127
Evil-unveiled.com/Reform Sex Offender Laws Campaign	22	18	40	43	0,000127
TheMysteriousMrEnter	67	228	295	34	0,000126
Anders Behring Breivik	102	100	202	58	0,000126
Maddox	75	172	247	19	0,000126
EXTREME ADVERTISING	71	24	95	9	0,000126
Domestic violence	107	42	149	39	0,000126
PC	69	7	76	49	0,000126
Histrionic Personality Disorder	40	19	59	8	0,000126
Evil-unveiled.com/Kidzlandonline.com	27	15	42	43	0,000126
Sargon Quest/Make YouTube	5	3	8	19	0,000126
Large Hadron Collider	61	129	190	46	0,000125
Dramacrat	64	8	72	8	0,000125
8chan	109	96	205	19	0,000125
The Money Shot	30	18	48	20	0,000125
Garfield	48	78	126	61	0,000125
NO NIGGERS	85	49	134	35	0,000125
Esperanto	35	58	93	37	0,000125
Pictures plz	81	16	97	8	0,000125
Heaven	62	74	136	46	0,000125
Fail to Win	11	51	62	9	0,000125
Plushie	116	50	166	31	0,000125
Pizza and Beer	72	34	106	52	0,000125
Gary Oak	59	38	97	9	0,000125
Scarlet	16	13	29	8	0,000125
The Big Bang Theory	33	110	143	7	0,000124
Swine Flu	69	200	269	35	0,000124
Alt-right	98	60	158	19	0,000124
Cracker	83	12	95	35	0,000124
The Burden of Proof	87	16	103	3	0,000124
DNS Comic	17	15	32	54	0,000124
Evil-unveiled.com/Common Ground	21	19	40	43	0,000124
Slashfic	65	66	131	21	0,000123
Luka Magnotta	69	70	139	25	0,000123
Parents	76	23	99	54	0,000123
Aneros	6	33	39	46	0,000123
J-Rock	26	78	104	28	0,000123
Fan Art	136	48	184	21	0,000122
Cheese1997	60	86	146	21	0,000122
Ted Haggard	49	67	116	46	0,000122
Trololo	32	14	46	9	0,000122
Debate	54	24	78	8	0,000122
Unikitty	18	71	89	34	0,000122
Clitoris	35	39	74	39	0,000122
Afrocentrism	12	171	183	35	0,000122
Hetalia	32	174	206	37	0,000122
BSD	52	55	107	10	0,000121
Rupert Murdoch	62	97	159	14	0,000121
White Nationalism	125	187	312	35	0,000121
RationalWiki	37	163	200	19	0,000121
Liberal Butthurt Syndrome	35	44	79	14	0,000121
National Security Agency	43	30	73	58	0,00012
EDF 2: Electric Boogaloo	113	131	244	52	0,00012
Jimmy Savile	60	154	214	17	0,00012
The Power 5	41	24	65	6	0,00012
IRL drama	19	31	50	8	0,00012
Gabe Newell	48	43	91	49	0,00012
Ragequit	200	28	228	19	0,00012
Kittens	62	0	62	25	0,00012
VonHelton	22	175	197	17	0,00012
Bodybuilder	62	61	123	0	0,00012
Evil-unveiled.com/AoA	29	1	30	43	0,00012
Bridget	55	17	72	28	0,000119
Original character	184	78	262	7	0,000119
I'm 12 years old and what is this?	126	30	156	9	0,000119
Mystery Science Theater 3000	38	61	99	61	0,000119
Shitskin Plantation	82	37	119	35	0,000119
Stormfront	82	109	191	14	0,000119
The Chemo That Is Curing /b/	73	22	95	9	0,000119
Category:Movies	59	0	59	22	0,000119
Skinhead	60	56	116	40	0,000119
Middle East	74	21	95	37	0,000119
Dongs	47	7	54	54	0,000119
Encyclopedia Dramatica:Stub	27	0	27	13	0,000119
Fag Enabler	36	28	64	40	0,000119
Gay hanky code	14	77	91	40	0,000119
Applemilk1988	59	146	205	48	0,000118
TsimFuckis	55	75	130	9	0,000118
Economy	56	107	163	17	0,000118
Smoking	90	110	200	13	0,000118
Romanians	58	153	211	37	0,000118
I'm so confused	52	45	97	29	0,000118
Richard Nixon	58	80	138	14	0,000118
Wikipedia Admin Gallery	61	69	130	2	0,000118
The Royal Family	64	290	354	27	0,000118
Ghost	48	123	171	56	0,000117
Not4chan	33	49	82	22	0,000117
DaxFlame	45	77	122	48	0,000117
Stephen Hawking	49	44	93	46	0,000117
Snakes on a Plane	52	54	106	22	0,000117
Seattle	59	50	109	8	0,000117
The Beatles	62	36	98	12	0,000117
Lens flare	75	34	109	21	0,000117
Amy Schumer	34	54	88	19	0,000117
Cracky-chan	73	56	129	9	0,000116
H√¶ti	68	87	155	35	0,000116
London Olympics	16	106	122	6	0,000116
The Great Dumbledore Dies Meme of 2005	40	43	83	8	0,000116
Friend Zone	87	61	148	36	0,000116
Circular logic	33	21	54	46	0,000116
Childfree	60	35	95	8	0,000116
Pic Unrelated	22	15	37	9	0,000116
Shay	42	36	78	52	0,000116
Natalie Portman	13	60	73	17	0,000116
Tomb Raider	53	92	145	32	0,000116
SapphyDracases	31	118	149	28	0,000116
Neon Genesis Evangelion	101	133	234	28	0,000115
Comments	58	22	80	8	0,000115
Pekka-Eric Auvinen	53	104	157	58	0,000115
Jock	92	54	146	58	0,000115
Terri Schiavo	73	34	107	14	0,000115
Anal Cunt	22	22	44	12	0,000115
Oral	45	10	55	19	0,000115
It is a mystery	120	21	141	19	0,000115
Video Game Reviewers	89	330	419	61	0,000115
Final Fantasy VI	21	130	151	29	0,000115
Streisand Effect	109	55	164	19	0,000114
BBC	70	105	175	17	0,000114
Madonna	53	48	101	36	0,000114
DrMusic2	44	164	208	7	0,000114
Gook	72	18	90	11	0,000114
Will Smith	60	45	105	9	0,000114
Shamwow	60	83	143	9	0,000113
That Guy With The Glasses	97	109	206	61	0,000113
Topkek	18	35	53	9	0,000113
Roblox	35	123	158	20	0,000113
Angry Video Game Nerd	111	157	268	61	0,000113
Admiral Ackbar	71	25	96	9	0,000113
Non-notable	92	18	110	2	0,000113
Sittin On Tha Toilet	32	44	76	21	0,000113
Main Page/did you know	2	20	22	19	0,000113
Pagan	102	81	183	27	0,000112
EverQuest	68	246	314	49	0,000112
Taking Down ED	120	152	272	48	0,000112
The Rapture	71	85	156	46	0,000112
Daniel Brandt	67	68	135	2	0,000112
Warhammer 40,000	74	247	321	22	0,000112
In before X	44	43	87	9	0,000112
BME	43	68	111	63	0,000112
South Africa	52	102	154	35	0,000112
Arbchat	30	9	39	2	0,000112
Suburbs	65	57	122	12	0,000112
Eproctophilia	86	32	118	34	0,000112
Incarnate	30	58	88	28	0,000112
Icon	42	19	61	8	0,000112
Opie and Anthony	22	166	188	17	0,000112
Jedi	25	24	49	33	0,000112
Grand Theft Auto	124	42	166	49	0,000111
Ukraine	41	328	369	37	0,000111
PeppermintPatti	44	65	109	48	0,000111
Charles Manson	56	64	120	12	0,000111
IP address	94	32	126	2	0,000111
Sparkledogs	69	95	164	24	0,000111
Robert Wayne Stiles	39	253	292	7	0,000111
Egypt	70	64	134	37	0,000111
Culture	31	47	78	37	0,000111
Demon	38	33	71	46	0,000111
Liberal Party of Australia	16	78	94	14	0,000111
Onigojirakaiju	45	117	162	24	0,000111
Child Abduction	25	18	43	34	0,000111
Screencap	76	43	119	21	0,000111
Hawaiian Dicking	36	12	48	39	0,000111
Larry Craig	57	42	99	14	0,000111
Evil-unveiled.com/Age Taboo	14	17	31	43	0,000111
BLANKING IN PROGRESS	100	17	117	24	0,00011
SWATting	67	50	117	26	0,00011
Dick Neck	41	73	114	4	0,00011
Mikese Morse	8	19	27	35	0,00011
Watermelonz	56	29	85	35	0,00011
Acne	59	29	88	26	0,00011
Magick	70	48	118	27	0,00011
Metal	83	8	91	12	0,00011
Main Page	35	1	36	8	0,00011
‚ô•	41	40	81	52	0,00011
Dick Ants	15	10	25	9	0,00011
Trolltalk	12	97	109	9	0,00011
Evil-unveiled.com/Sex Offender Support and Education Network	27	20	47	43	0,00011
Wii	100	101	201	49	0,000109
Youtube Nobodies	122	190	312	48	0,000109
Gore	82	13	95	22	0,000109
Crimes	58	52	110	35	0,000109
Dan Savage	15	35	50	40	0,000109
The Wikipedia Jews	65	56	121	2	0,000109
Sailor Moon	102	148	250	28	0,000109
Toilet Seat	24	27	51	39	0,000109
Emilie Autumn	19	91	110	12	0,000109
Evil-unveiled.com/Open Hands	12	4	16	43	0,000109
Richard Stallman	55	72	127	10	0,000108
Typo	57	28	85	3	0,000108
7 Proxies	90	14	104	9	0,000108
December 21, 2012	14	60	74	46	0,000108
Neo-con	72	43	115	14	0,000108
Gothzilla	44	231	275	22	0,000108
Abraham Lincoln	27	17	44	14	0,000108
DivineAngel	46	74	120	21	0,000108
Jam It In	45	14	59	28	0,000108
Jailhouse Gay	25	14	39	39	0,000108
Evil-unveiled.com/AlbertRoss	5	4	9	43	0,000108
Evil-unveiled.com/Bach	7	10	17	43	0,000108
Nurse-kun/Damaged Goods/Chapter 21	5	2	7	53	0,000108
The Sandwich Chef	43	18	61	9	0,000107
Rootbrian	66	183	249	48	0,000107
LulzSec	46	71	117	10	0,000107
Dead babies	73	40	113	1	0,000107
Street Fighter 2	85	183	268	49	0,000107
MSN	67	81	148	3	0,000107
Juliana Wetmore	63	54	117	56	0,000107
Zeriara	66	69	135	21	0,000107
New Zealand Fail Guy	16	18	34	9	0,000107
Jolene JRyda	18	91	109	51	0,000107
Hungary	31	44	75	37	0,000107
Fourth wall	14	46	60	34	0,000107
Bix Nood	82	17	99	35	0,000106
Chris-chan/Sonichu	111	120	231	7	0,000106
Bernie Sanders	67	73	140	19	0,000106
NeoPets	82	126	208	38	0,000106
Iceland	36	65	101	37	0,000106
Dongcopter	57	30	87	49	0,000106
Anna Nicole Smith	55	66	121	36	0,000106
Cell Phone	51	40	91	8	0,000106
Yuppie	72	103	175	35	0,000106
Wordfilter	37	59	96	9	0,000105
Fred	66	93	159	61	0,000105
Tawneelynne	26	62	88	8	0,000105
WikiFur	61	81	142	31	0,000105
George Herbert Walker Bush	22	41	63	14	0,000105
System32	48	23	71	10	0,000105
BBW	65	4	69	52	0,000105
Holocaust Porn	21	18	39	17	0,000105
Good Korea	55	29	84	37	0,000105
‡≤† ‡≤†	35	11	46	9	0,000104
Mac OS	41	96	137	10	0,000104
Shut Up, Little Man!	6	13	19	11	0,000104
Lulzcon	22	11	33	1	0,000104
Ayn Rand	73	114	187	14	0,000104
Milo Yiannopoulos	83	171	254	19	0,000104
Yuri	50	23	73	28	0,000104
Martin Luther King, Jr.	53	99	152	35	0,000104
Intellectual	66	42	108	46	0,000104
Sephiroth	57	81	138	29	0,000104
Forever	32	3	35	37	0,000104
X Everywhere	31	63	94	9	0,000104
Tween	42	35	77	36	0,000104
Missouri	27	71	98	35	0,000104
Comment whore	40	16	56	8	0,000104
Fuck The Police	40	68	108	35	0,000104
Dyslexia	48	22	70	23	0,000104
Jerry Seinfeld	51	50	101	17	0,000104
Gay.pl	26	24	50	10	0,000104
Final Fantasy VIII	13	78	91	29	0,000104
Tony Eveready	16	12	28	36	0,000104
Sp/	51	107	158	9	0,000103
Budd Dwyer	39	58	97	58	0,000103
J-Pop	39	37	76	28	0,000103
EverQuest II	70	227	297	49	0,000103
Lulz News Network	21	14	35	8	0,000103
Trayvon Martin	67	103	170	35	0,000103
Imaginary girlfriend	64	32	96	7	0,000103
Black Lives Matter	99	215	314	35	0,000103
U WOT M8	39	72	111	42	0,000103
Dubai	28	66	94	37	0,000103
Unbirthing	37	19	56	31	0,000103
Maury	51	47	98	36	0,000103
I'm so random	38	66	104	12	0,000103
Kim Kardashian	24	51	75	36	0,000103
Radio	48	115	163	17	0,000102
Deleting your LiveJournal	78	18	96	8	0,000102
Duke Nukem Forever	46	117	163	49	0,000102
Blu Aardvark	54	67	121	2	0,000102
Snitch	55	17	72	10	0,000102
Meme Combining	32	47	79	9	0,000102
NIGGER MANUAL	32	52	84	35	0,000102
Bush	63	14	77	14	0,000102
FA	52	3	55	31	0,000102
Then who was X	70	78	148	37	0,000102
Nietzsche	47	112	159	46	0,000102
POV	24	10	34	2	0,000102
P-p-p-powerbook	53	35	88	8	0,000101
Jake Brahm	39	64	103	9	0,000101
Nu-male	66	100	166	19	0,000101
Bleach	91	162	253	28	0,000101
Wishlist	33	31	64	8	0,000101
Queen	47	8	55	37	0,000101
7-Eleven	33	22	55	35	0,000101
C	42	39	81	10	0,000101
Shitpost	74	10	84	9	0,000101
Time paradox	69	25	94	32	0,000101
American Idol	67	64	131	29	0,000101
Cougar	38	15	53	48	0,000101