Id,Label,timeset,indegree,outdegree,Degree,modularity_class,pageranks
"!",,,10,17,27,21,0.000045
Canon,,,57,53,110,21,0.000091
You,,,3200,384,3584,13,0.006796
FanFiction,,,433,98,531,21,0.00042
Yaoi,,,229,66,295,28,0.000312
Dragon,,,96,98,194,31,0.000138
Tubgirl,,,260,26,286,6,0.000467
Harry Potter,,,314,198,512,6,0.000651
Not,,,385,42,427,47,0.000572
Programming language,,,15,16,31,10,0.000026
ZOMG,,,119,22,141,48,0.000186
Special:RecentChanges,,,5,0,5,51,0.000014
IRL,,,1824,48,1872,8,0.003265
Oneoneone,,,303,38,341,21,0.000559
Ellipsis,,,16,17,33,41,0.00004
Asterisk,,,3,8,11,10,0.000015
Underscore,,,3,17,20,11,0.000017
@,,,4,8,12,7,0.000019
"!Mike",,,0,2,2,21,0.000011
DeviantART,,,1142,291,1433,21,0.001414
CP,,,857,73,930,53,0.001324
"""Bob""",,,0,22,22,46,0.000011
Cthulhu,,,115,50,165,46,0.000243
Star Wars,,,409,213,622,33,0.000654
Jameth,,,161,77,238,8,0.000551
Retard,,,3998,126,4124,38,0.004958
Basement-dweller,,,1724,155,1879,49,0.002004
OTI,,,187,10,197,41,0.000629
Faggot,,,3827,73,3900,0,0.005615
Church of the SubGenius,,,13,36,49,46,0.000031
Religion,,,339,123,462,46,0.000754
Wicca,,,183,118,301,27,0.000233
Pagan,,,102,81,183,27,0.000112
Television,,,233,27,260,34,0.000447
Monty Python,,,44,45,89,17,0.000083
RAGE,,,984,119,1103,61,0.001091
Unfunny,,,1357,104,1461,61,0.00211
Copyright,,,132,36,168,48,0.000167
Internet lawsuit,,,363,40,403,48,0.000367
Assclown,,,17,12,29,46,0.000022
BBS,,,43,14,57,55,0.000139
Enzyte,,,7,18,25,41,0.000011
Profit,,,637,57,694,57,0.001107
"""Missing White Woman Syndrome""",,,26,35,61,39,0.000037
Fact,,,2965,94,3059,49,0.003929
Not be confused with,,,34,11,45,2,0.000096
Missing White Womyn Syndrome,,,14,36,50,41,0.000025
Old media,,,676,55,731,14,0.001125
White Devils,,,897,198,1095,35,0.001318
In the kitchen,,,226,59,285,39,0.000274
Lulz,,,3987,117,4104,1,0.005699
Ugly,,,806,48,854,36,0.00101
Some argue,,,1508,32,1540,29,0.002537
Wimmins,,,1241,222,1463,39,0.00208
Whore,,,2428,128,2556,36,0.003229
Mexico,,,753,231,984,35,0.001075
Wikipedia,,,1056,224,1280,2,0.002208
Over 9000,,,2467,60,2527,11,0.003462
Rule 34,,,741,166,907,9,0.001174
Citation needed,,,36,16,52,2,0.000088
Unwarranted Self-Importance,,,2112,102,2214,51,0.002279
Cocaine,,,398,39,437,35,0.000669
Asking for it,,,838,64,902,39,0.001198
Tabloid,,,69,87,156,19,0.0001
ALL CAPS,,,728,39,767,64,0.000989
Expert,,,84,24,108,13,0.000199
Virginia Tech Massacre,,,113,182,295,58,0.000162
EVAR,,,225,12,237,8,0.000401
MySpace,,,727,200,927,12,0.001031
Shannon Matthews,,,8,56,64,53,0.00003
Madeleine McCann,,,101,155,256,17,0.000203
Jennifer Wilbanks,,,1,32,33,8,0.000012
Hypnotoad,,,40,13,53,9,0.000152
Natalee Holloway,,,15,45,60,14,0.000022
Rachel Bruno,,,9,19,28,39,0.000019
Casey Anthony,,,31,70,101,36,0.000086
Almost raped,,,355,95,450,39,0.000487
$100 Laptop,,,14,31,45,10,0.000051
Terrorist,,,477,74,551,37,0.00066
Liberal guilt,,,67,42,109,35,0.000211
SmallTalk,,,5,38,43,37,0.000013
EBay,,,150,61,211,8,0.000226
Grawp,,,98,236,334,2,0.000193
Christian,,,945,284,1229,46,0.001361
Communism,,,670,156,826,14,0.001081
Shit,,,3096,6,3102,34,0.003792
Open Source,,,61,59,120,10,0.000099
Richard Stallman,,,55,72,127,10,0.000108
Pedobear,,,757,158,915,53,0.001442
P-p-p-powerbook,,,53,35,88,8,0.000101
Lunix,,,227,118,345,10,0.000433
Crap,,,1268,117,1385,21,0.002136
Fail,,,3740,56,3796,32,0.004761
Internet stalking,,,438,90,528,59,0.000427
Pedo,,,567,6,573,53,0.000699
TL;DR,,,1391,40,1431,5,0.002096
Liar,,,3600,60,3660,19,0.004437
Rape,,,3394,163,3557,39,0.004729
Jenkem,,,229,42,271,35,0.000327
Doom,,,103,120,223,49,0.000129
AIDS,,,1395,84,1479,40,0.002354
Nigger,,,2346,240,2586,35,0.003627
419 Nigerian Email Scams,,,137,43,180,64,0.000296
Linux for Niggers,,,18,23,41,35,0.000042
( ͡° ͜ʖ ͡°),,,13,27,40,9,0.000033
S4s/,,,36,61,97,9,0.000075
4chan Gold Account,,,26,23,49,9,0.000054
Palestine,,,93,121,214,37,0.000175
Trollface,,,174,91,265,9,0.000295
Muhammad Cartoons,,,88,113,201,37,0.000169
So cash,,,165,91,256,9,0.00029
4chan bans,,,16,47,63,9,0.000039
Oh exploitable,,,363,134,497,9,0.000706
Cockmongler,,,207,45,252,9,0.000414
Party Van,,,1129,75,1204,9,0.001702
Moot,,,395,110,505,9,0.000731
Triforce,,,31,44,75,9,0.000054
Keep Calm and Carry On,,,14,63,77,37,0.000035
Reaction Face,,,57,21,78,9,0.000142
Tattoo,,,48,39,87,36,0.000081
My Little Pony,,,362,175,537,7,0.001102
Reddit,,,306,232,538,19,0.000418
Neutral Milk Hotel,,,31,38,69,12,0.00005
"ಠ ಠ",,,35,11,46,9,0.000104
Emoticon,,,114,126,240,54,0.000274
Copypasta,,,532,60,592,9,0.000869
9gag,,,77,112,189,9,0.000244
2012 (disambiguation),,,306,8,314,14,0.000563
Plush Pedobear,,,8,10,18,53,0.000025
That Really Rustled My Jimmies,,,34,37,71,9,0.000076
(dic),,,1,9,10,8,0.000015
(sic),,,66,19,85,3,0.000097
Your Mom,,,1140,112,1252,54,0.002355
Omgwtfbbq,,,37,11,48,8,0.000068
Cat,,,353,111,464,25,0.00095
Castration,,,116,55,171,63,0.000199
Please advise,,,4,4,8,8,0.000019
Bisexual,,,308,67,375,12,0.000442
Grammar Nazi,,,238,58,296,3,0.000521
Internets,,,2534,181,2715,3,0.004832
Slipknot,,,43,77,120,12,0.000093
Etymology,,,4,14,18,27,0.000019
Fucktard,,,1190,82,1272,16,0.001529
MONGO,,,118,60,178,2,0.000267
Typo,,,57,28,85,3,0.000108
Wapanese,,,1328,220,1548,28,0.002212
Japan,,,832,173,1005,28,0.001503
Sick fuck,,,1609,195,1804,22,0.002607
Fellatio,,,993,52,1045,54,0.001424
Common knowledge,,,256,73,329,3,0.000401
Shit no one cares about,,,3292,50,3342,15,0.003812
Godwin's Law,,,142,48,190,41,0.000277
WHY IS THERE AN ARTICLE?,,,22,0,22,32,0.000064
*chan Soundtracks,,,3,21,24,9,0.000012
Lulz: A Corruption of LOL,,,18,29,47,26,0.000049
Radio,,,48,115,163,17,0.000102
Raidchan,,,11,41,52,9,0.000028
Radiohead,,,18,72,90,12,0.000031
Avant-garde,,,32,52,84,12,0.000097
Doubles,,,38,51,89,9,0.000055
Pedophilia,,,2053,191,2244,53,0.002715
Aleksandr Pistoletov,,,14,20,34,37,0.000034
OC,,,87,14,101,9,0.000095
Fat Larry's Band,,,259,316,575,12,0.000512
Gorillaz,,,25,90,115,21,0.000039
Guile,,,9,14,23,49,0.000021
Attack on Titan,,,20,97,117,28,0.00002
Lupchan,,,3,14,17,9,0.000011
2013,,,221,47,268,58,0.000525
Nope.avi,,,121,4,125,49,0.000149
Chan,,,215,152,367,9,0.000369
Lulzcore,,,6,100,106,9,0.000025
Futuristic Sex Robotz,,,21,145,166,10,0.000054
*chan Soundtracks/Ultimate Soundtr/a/ck,,,0,1,1,28,0.000011
Mari Iijima,,,7,15,22,28,0.000022
*chan memes,,,3,59,62,9,0.000015
4chan,,,1482,326,1808,9,0.002891
Dicks Everywhere,,,31,10,41,9,0.000074
4chan Battlecards,,,10,15,25,9,0.000063
A FUCKING POKEMON,,,17,8,25,26,0.00007
Nurse-kun,,,16,60,76,53,0.000053
A Cat Is Fine Too,,,159,42,201,25,0.000521
Acky-chan-cray,,,4,7,11,9,0.000015
Bitches Don't Know,,,105,178,283,9,0.000219
Bix Nood,,,82,17,99,35,0.000106
Bridget,,,55,17,72,28,0.000119
Caturday,,,100,42,142,25,0.000181
Chin-chan,,,49,65,114,9,0.000128
Cooldude,,,92,29,121,57,0.000147
Cracky-chan,,,73,56,129,9,0.000116
Demotivators,,,65,55,120,9,0.000215
Dental Plan,,,48,18,66,9,0.000055
Desu,,,250,88,338,9,0.000457
Divide by zero,,,598,57,655,46,0.000935
DO NOT WANT,,,771,61,832,56,0.001263
Doug,,,27,56,83,34,0.00006
Poeticirony,,,62,35,97,31,0.000144
FGSFDS,,,47,37,84,9,0.000081
Epic Fail Guy,,,192,59,251,9,0.000333
FUCK YEA,,,14,35,49,9,0.00005
Furseiseki,,,12,32,44,31,0.000016
Gaijin 4Koma,,,22,23,45,9,0.000058
Gaston,,,29,73,102,9,0.000161
George Zimmer,,,33,22,55,9,0.000043
Goofy Time,,,78,26,104,9,0.000139
ITTY BITTY BABY ITTY BITTY BOAT,,,60,32,92,9,0.000097
Happy Negro,,,53,30,83,9,0.000131
Herb Smith,,,4,15,19,9,0.000012
How Do I Shot Web?,,,145,63,208,9,0.00017
IMMA CHARGIN MAH LAZER,,,292,53,345,9,0.000359
Is This Battletoads,,,153,88,241,49,0.000206
Loli-chan,,,9,22,31,9,0.000023
Longcat,,,171,62,233,25,0.000301
Machine Code,,,29,23,52,9,0.000053
Moar,,,999,27,1026,21,0.001584
Nod Flenders,,,23,86,109,9,0.000036
7 Proxies,,,90,14,104,9,0.000108
O Noes Her Nanomachines!11!!,,,12,38,50,28,0.000015
Party Hard,,,156,47,203,9,0.000232
WE'RE GOING BACK TO POTATOS TO GET MY FUCKING POWER WRIST,,,9,10,19,9,0.000019
Raptor Jesus,,,212,40,252,46,0.000433
Sauce,,,102,26,128,9,0.000238
Shitting Dick Nipples,,,129,15,144,31,0.000279
Speedycat,,,20,14,34,9,0.000037
The Sandwich Chef,,,43,18,61,9,0.000107
That Fucking Cat,,,85,52,137,9,0.000131
VTEC Just Kicked In Yo,,,45,28,73,58,0.000049
Winston Churchill,,,18,21,39,37,0.000069
WRYYYYYYYYYYYYYYYYYYYY,,,52,21,73,9,0.000058
Zippocat,,,67,32,99,25,0.00014
Wordfilter,,,37,59,96,9,0.000105
*facepaws*,,,3,7,10,31,0.000021
Darkfox,,,4,19,23,31,0.00002
Darkfox/Arbchat,,,2,3,5,31,0.000014
Emotes,,,15,37,52,41,0.000061
Facepalm,,,492,75,567,32,0.000669
Furfag,,,2852,231,3083,31,0.004478
Skuee/Arbchat log,,,2,1,3,48,0.000014
Dreadnought/logs,,,2,1,3,41,0.000014
*nix,,,12,15,27,10,0.000054
UNIX,,,53,50,103,10,0.000133
Windows,,,251,155,406,10,0.000463
LOL WUT,,,1615,46,1661,21,0.001684
BSD,,,52,55,107,10,0.000121
Awesome,,,593,152,745,5,0.001058
Ubuntu,,,27,118,145,10,0.000079
Solaris,,,9,14,23,10,0.000024
Mac OS,,,41,96,137,10,0.000104
Game Boy Advance,,,29,38,67,49,0.000039
God,,,1025,265,1290,46,0.00168
Something Awful,,,374,179,553,8,0.000784
.glass.,,,2,1,3,41,0.000033
ASCII,,,75,8,83,41,0.00021
.hack,,,2,48,50,28,0.000013
Animu,,,1013,236,1249,28,0.001613
Cyberpunk,,,17,34,51,10,0.000031
Satan,,,580,118,698,46,0.000807
Computer,,,169,77,246,10,0.000258
Emo,,,2019,198,2217,12,0.003201
Teh,,,196,27,223,3,0.000529
Encyclopædia Dramatica,,,976,100,1076,2,0.002117
Lolicon,,,1244,95,1339,28,0.001736
Anne Rice,,,24,50,74,27,0.000035
Earth,,,163,47,210,46,0.000315
MMORPG,,,165,139,304,49,0.000196
13-year-old boy,,,1582,198,1780,4,0.00202
Men,,,402,55,457,39,0.000699
Girl,,,108,27,135,12,0.000209
Mary Sue,,,537,160,697,21,0.000384
Stupid,,,1033,63,1096,24,0.001335
Slashfic,,,65,66,131,21,0.000123
The Matrix,,,147,63,210,17,0.000237
Last Thursday,,,1574,25,1599,53,0.001777
Fantard,,,950,140,1090,49,0.000819
Neon Genesis Evangelion,,,101,133,234,28,0.000115
LSD,,,125,38,163,17,0.000134
Pokémon,,,659,295,954,28,0.000969
Za Warudo,,,80,18,98,9,0.0001
What,,,1084,114,1198,56,0.001204
B/,,,1396,167,1563,9,0.002237
The Internet is serious business,,,1341,67,1408,5,0.001619
Antisocial personality disorder,,,40,39,79,30,0.000063
Internet Tough Guy,,,1151,164,1315,51,0.001264
Attention Whore,,,1720,99,1819,36,0.002015
Opinion,,,77,42,119,19,0.000172
.se,,,2,5,7,37,0.000011
Sweden,,,178,131,309,37,0.000324
No,,,1230,52,1282,44,0.001247
0-day,,,7,4,11,10,0.000017
Exploit,,,10,19,29,31,0.000024
Raven,,,6,39,45,10,0.00002
001rich100,,,1,91,92,49,0.000011
Americunts,,,909,234,1143,37,0.001486
Anger,,,83,91,174,17,0.000173
Celebrity,,,140,36,176,36,0.000195
Manchild,,,290,133,423,7,0.000247
Metroid,,,62,136,198,49,0.000081
Lol,,,1454,47,1501,48,0.001853
Buttsecks,,,1822,59,1881,40,0.002595
Dildo,,,409,61,470,40,0.000602
Lego,,,37,79,116,49,0.000074
Shit Bricks,,,296,36,332,9,0.000436
Caveman,,,26,25,51,35,0.000029
Butthurt,,,2649,86,2735,24,0.002886
Chris-chan,,,1040,244,1284,7,0.001622
Michael Bay,,,39,36,75,34,0.000062
Pr0n,,,1489,108,1597,18,0.002388
Legend of Zelda,,,115,127,242,49,0.00016
Death,,,748,52,800,13,0.001142
Bad,,,60,6,66,49,0.000059
Michael,,,5,29,34,14,0.000022
Vomit,,,133,39,172,6,0.000167
Chris-chan/Sonichu,,,111,120,231,7,0.000106
Wii,,,100,101,201,49,0.000109
Cum,,,1173,40,1213,20,0.001772
Recoloring,,,94,30,124,21,0.000066
Bullshit,,,2258,82,2340,23,0.002537
YOU ARE DOING IT WRONG,,,985,66,1051,21,0.002062
Sony Vegas,,,17,38,55,10,0.000032
Transgender,,,660,168,828,19,0.000862
Cock,,,2541,214,2755,63,0.003954
Thanks Obama,,,13,21,34,7,0.000021
Nobody,,,208,7,215,15,0.000227
Fisting,,,97,40,137,40,0.000185
Homosexuality,,,3495,212,3707,40,0.004869
Scissoring,,,44,16,60,28,0.000099
Computer Graphics,,,36,23,59,49,0.000062
Nintendo DS,,,45,60,105,49,0.00008
Lonely,,,209,52,261,28,0.000242
JewTube,,,345,10,355,48,0.000416
Legal action,,,50,23,73,8,0.000091
Asperger's Syndrome,,,2141,289,2430,7,0.002479
Star Trek,,,220,127,347,33,0.000357
Ship,,,100,170,270,28,0.000096
Sonic the Hedgehog,,,428,282,710,7,0.000414
Noone,,,642,23,665,41,0.000815
Original character,,,184,78,262,7,0.000119
Dick,,,390,19,409,34,0.000543
Paul Walker,,,13,27,40,36,0.000038
Ass,,,670,20,690,34,0.00093
Imaginary,,,49,10,59,19,0.000033
Loser,,,725,81,806,34,0.000712
Sarcasm,,,607,44,651,15,0.000563
Cool story bro,,,202,48,250,15,0.000246
Basement,,,148,6,154,13,0.000164
CSI,,,52,51,103,10,0.000092
National Security Agency,,,43,30,73,58,0.00012
Whatever,,,46,9,55,5,0.000081
Rofl,,,82,20,102,26,0.000178
Fat,,,2258,154,2412,52,0.003336
Mariotehplumber,,,37,131,168,7,0.000052
Video games,,,349,193,542,49,0.000438
Derp,,,195,27,222,61,0.000229
????,,,355,21,376,57,0.000695
Tony Stark,,,45,32,77,34,0.000083
Failbook,,,778,249,1027,59,0.001229
007,,,0,5,5,37,0.000011
Goldeneye 007,,,14,44,58,49,0.000019
James Bond,,,31,100,131,37,0.000041
Spies,,,57,27,84,26,0.000044
Leave Bond to me,,,31,47,78,37,0.000055
Meme,,,928,74,1002,9,0.001717
03bgood,,,19,94,113,34,0.000036
Powerword,,,947,32,979,7,0.000824
Nintendo,,,229,58,287,49,0.000256
Halo,,,193,77,270,49,0.000201
Grand Theft Auto,,,124,42,166,49,0.000111
Call of Duty,,,178,53,231,49,0.000204
Jesus,,,768,182,950,46,0.001275
Fetish,,,378,70,448,31,0.000442
Lol-cow,,,823,175,998,7,0.000903
DO IT FAGGOT,,,530,57,587,13,0.000727
Incontinent Student Bodies,,,1409,51,1460,16,0.001403
Cool Cat,,,8,27,35,7,0.000014
TheMysteriousMrEnter,,,67,228,295,34,0.000126
Retro,,,133,45,178,61,0.000137
Future,,,50,84,134,34,0.000056
Oh noes,,,182,48,230,3,0.000192
Derek Savage,,,10,40,50,7,0.000016
Gravity Falls,,,45,103,148,34,0.000046
Steven Universe,,,64,158,222,34,0.000066
Richard Dawkins,,,101,143,244,46,0.000171
Adult Swim,,,101,150,251,34,0.00018
Disney,,,333,175,508,34,0.00044
United Kingdom,,,554,225,779,37,0.000902
Delete fucking everything,,,1017,172,1189,44,0.000906
IGN,,,38,95,133,49,0.000039
PlayStation 4,,,17,9,26,49,0.000021
Xbox One,,,22,87,109,49,0.000048
Doll,,,10,14,24,39,0.000014
Ghost,,,48,123,171,56,0.000117
Adam Lanza,,,87,113,200,58,0.000147
Irony,,,1232,55,1287,62,0.001572
Azn,,,953,147,1100,11,0.001386
Goatse,,,1831,138,1969,6,0.002902
Barack Obama,,,406,235,641,14,0.001425
TV Tropes,,,117,174,291,2,0.000225
Family Guy,,,210,141,351,34,0.000369
SpongeBob Squarepants,,,113,95,208,34,0.000243
The Fairly OddParents,,,34,96,130,34,0.000038
IMDb,,,65,90,155,44,0.00008
Islamic State of Iraq and Syria,,,136,97,233,37,0.000219
YouTube,,,1535,202,1737,48,0.001893
Gangbang,,,128,52,180,36,0.000179
The Powerpuff Girls,,,33,57,90,34,0.000032
Viacom,,,61,110,171,34,0.000064
Shotacon,,,427,73,500,28,0.000807
Clone,,,19,0,19,49,0.000018
Lesbian,,,954,109,1063,42,0.00151
Rick and Morty,,,45,115,160,34,0.000056
Science,,,353,90,443,46,0.000655
MILF,,,179,50,229,36,0.000224
Incest,,,862,44,906,42,0.001213
Why So Serious?,,,150,106,256,9,0.000222
Bitch,,,1024,33,1057,36,0.001251
Lindsay Lohan,,,56,64,120,36,0.000145
Clay Claymore,,,21,35,56,34,0.000021
Obsessive Compulsive Disorder,,,121,26,147,7,0.000161
Spax3,,,71,51,122,61,0.000135
Benthelooney,,,22,130,152,34,0.000021
Meta527II,,,19,72,91,34,0.00008
Bullying,,,105,116,221,13,0.000133
Troll,,,3044,110,3154,41,0.004029
09 F9 11 02 9D 74 E3 5B D8 41 56 C5 63 56 88 C0,,,9,24,33,10,0.000023
Mathematics,,,78,83,161,11,0.000191
42,,,43,44,87,23,0.000051
Freedom of speech,,,110,103,213,37,0.000097
Digg,,,73,101,174,10,0.000095
Pwnt,,,1826,79,1905,60,0.002708
Circle jerk,,,354,38,392,61,0.000333
Hal Turner,,,111,202,313,26,0.000246
Pirate,,,197,89,286,10,0.000256
Bug Chasers,,,32,22,54,44,0.000099
Fap,,,2165,183,2348,18,0.002917
9ec4c12949a4f31474f299058ce2b22a,,,1,5,6,54,0.000011
1337,,,589,60,649,10,0.001188
Hacker,,,681,169,850,10,0.000765
Numberwang,,,8,108,116,9,0.000036
Streisand Effect,,,109,55,164,19,0.000114
Blu-ray,,,15,87,102,49,0.000043
0 apathetic 0,,,2,29,31,8,0.000034
Friends,,,242,36,278,8,0.000386
Blasphemy whore,,,1,41,42,8,0.000012
Deleting your LiveJournal,,,78,18,96,8,0.000102
Camwhore,,,687,101,788,8,0.001086
Internet drama,,,122,30,152,8,0.000252
LJ Abuse,,,73,23,96,8,0.000229
Adolf Hitler,,,976,157,1133,37,0.001619
16-year-old girl,,,1404,143,1547,21,0.002083
Virgin,,,904,100,1004,38,0.001125
Rating communities,,,24,23,47,8,0.000069
Community,,,116,9,125,8,0.000225
H8,,,334,23,357,21,0.00029
Law 4 Kids,,,22,39,61,9,0.000035
Friends only,,,78,15,93,8,0.000135
Journal,,,84,28,112,8,0.000204
Moderator,,,512,84,596,9,0.000558
Snark,,,18,16,34,8,0.000038
Goth,,,511,133,644,12,0.000653
Friends list,,,48,11,59,8,0.000133
Internet Disease,,,234,39,273,8,0.000489
Fat Girl Angle Shot,,,159,40,199,52,0.000284
0 pedophiles,,,2,24,26,8,0.000027
LiveJournal,,,880,68,948,8,0.001881
Serial adder,,,15,14,29,8,0.000054
Chris Hansen,,,294,89,383,53,0.0004
Russia,,,520,212,732,37,0.000822
Ashi moto,,,7,22,29,8,0.000017
Victim complex,,,397,119,516,39,0.000492
And nothing of value was lost,,,138,17,155,1,0.000166
Church,,,56,25,81,46,0.000097
AnonTalk,,,85,151,236,9,0.000179
12chan,,,71,43,114,9,0.000171
Michael Jackson,,,307,191,498,53,0.000608
NAMBLA,,,186,73,259,43,0.000365
Not racist,,,80,44,124,35,0.000143
Dubious disclaimer,,,66,33,99,8,0.000245
1-14 Jakarta Attacks,,,2,17,19,37,0.000011
Captain Obvious,,,583,60,643,17,0.000765
Tsunami,,,31,35,66,46,0.000051
High Score,,,239,281,520,58,0.000277
An hero,,,2242,160,2402,58,0.002912
Allahu Akbar,,,42,48,90,37,0.000056
2016,,,240,136,376,19,0.000249
Counter-Strike,,,121,139,260,49,0.000176
ISIS Paris Attack 13-11,,,28,72,100,37,0.000047
Sand niggers,,,469,137,606,37,0.000799
Terrorism,,,183,64,247,37,0.000264
Suicide,,,1025,196,1221,13,0.001507
Pulse Nightclub Massacre,,,55,101,156,58,0.000157
10,,,4,5,9,37,0.000012
NO BINARIES,,,8,11,19,41,0.000022
All Your Base Are Belong To Us,,,147,54,201,37,0.000216
Pun,,,104,4,108,7,0.000253
1000 Degree Knife,,,6,17,23,23,0.00002
Nice try,,,330,29,359,21,0.000382
9/11,,,653,145,798,37,0.001105
BLMKidnapping,,,11,32,43,35,0.000015
DINDUNUFFIN,,,66,25,91,35,0.00008
Clickbait,,,53,66,119,19,0.000072
Knife,,,20,31,51,58,0.00003
K/,,,64,145,209,0,0.000088
Will It Blend?,,,11,12,23,39,0.000062
10:10,,,2,11,13,25,0.000012
Environmentalism,,,40,43,83,14,0.000058
Londonistan,,,113,105,218,37,0.000131
Europe,,,360,128,488,37,0.000704
Global Warming,,,103,86,189,46,0.000159
PETA,,,160,119,279,25,0.000255
Greenpeace,,,20,60,80,25,0.000047
Animal Liberation Front,,,38,83,121,25,0.000057
Al Gore,,,206,66,272,14,0.00054
Climategate,,,12,18,30,46,0.000033
11/9,,,1,24,25,19,0.000011
JEWS DID WTC,,,486,68,554,17,0.001056
Funny,,,253,67,320,13,0.000439
Jewnited States of Americunts,,,1344,291,1635,37,0.002098
At least 100,,,2134,34,2168,47,0.003311
Transtrender,,,17,13,30,19,0.000047
Teenager,,,337,148,485,12,0.00053
Liberal,,,529,9,538,14,0.000775
The Donald,,,388,162,550,19,0.000663
Hillary Clinton,,,244,172,416,19,0.000493
2016 Presidential Election,,,66,101,167,19,0.000083
Dog,,,204,66,270,25,0.000297
Harambe,,,24,17,41,19,0.000064
Deez Nuts,,,9,42,51,9,0.00002
Bernie Sanders,,,67,73,140,19,0.000106
Black,,,347,3,350,63,0.000557
12-year-old girl,,,275,75,350,16,0.000385
Miley Cyrus,,,98,118,216,36,0.000228
High School Musical,,,25,64,89,36,0.000038
ICarly,,,27,81,108,34,0.000052
Jonas Brothers,,,87,78,165,12,0.000194
Justin Bieber,,,234,209,443,12,0.000396
Twilight,,,322,192,514,32,0.000562
Jailbait,,,440,40,480,28,0.000641
Unrealistic expectations,,,874,137,1011,27,0.000863
Tits,,,818,45,863,28,0.001142
Katy Perry,,,38,60,98,36,0.000043
Typical,,,558,54,612,49,0.000957
Sheep,,,130,22,152,61,0.00016
Scene,,,209,166,375,12,0.000375
My Chemical Romance,,,114,102,216,12,0.000222
Tracing,,,206,117,323,21,0.000176
Fan Art,,,136,48,184,21,0.000122
NeoPets,,,82,126,208,38,0.000106
Secks,,,1900,95,1995,50,0.003009
G.R.I.D.S.,,,108,37,145,40,0.000345
Cheese1997,,,60,86,146,21,0.000122
Wolfaboo,,,93,160,253,31,0.000164
Otherkin,,,414,107,521,31,0.000608
A frank discussion of mental illness,,,140,58,198,58,0.000232
School,,,273,273,546,58,0.000393
Beastiality,,,130,1,131,31,0.00021
Twatter,,,606,154,760,19,0.00073
Ashley Tisdale,,,11,47,58,9,0.000028
Generation Z,,,41,79,120,19,0.000094
Permaloli,,,9,40,49,28,0.000034
Prostitot,,,85,22,107,36,0.000149
Jessi Slaughter,,,176,181,357,12,0.000251
Wikichan/Adventures of the Brewsky Loli,,,1,1,2,28,0.000015
Wikichan/Bible Black and a 12 year old,,,1,0,1,16,0.000015
Wikichan/Chinese Weaboo Incest,,,1,1,2,16,0.000015
Wikichan/Jen,,,1,0,1,16,0.000015
Wikichan/Navy boats,,,1,0,1,16,0.000015
Wikichan/Postit Tits,,,2,1,3,16,0.000033
Wikichan/Tito,,,4,2,6,22,0.000032
Faux News,,,456,156,612,14,0.000991
420chan,,,101,160,261,9,0.000188
Killchan,,,3,12,15,9,0.000016
Renchan,,,7,42,49,0,0.00002
Partyvan,,,219,7,226,26,0.000236
Sarah Butts,,,78,146,224,19,0.000062
Kevin Strom,,,9,12,21,41,0.000017
Gary Glitter,,,40,56,96,17,0.000091
Xenuria,,,3,11,14,31,0.000021
Anonymous,,,1493,131,1624,26,0.002087
John McCain,,,88,111,199,14,0.00015
Comicality,,,6,42,48,53,0.000038
Chris Crocker,,,185,100,285,40,0.000349
Evil-unveiled.com/12chan,,,1,1,2,9,0.000014
BRBFBI,,,15,18,33,39,0.000042
Not4chan,,,33,49,82,22,0.000117
Brad Dayley,,,4,40,44,39,0.000017
12chan/Logs,,,1,3,4,1,0.000014
Grandmothers,,,49,15,64,54,0.000099
IRC,,,479,46,525,41,0.001046
12chan/Logs/PreRaidLogs,,,1,0,1,1,0.000015
AOL Instant Messenger,,,120,75,195,8,0.000283
BYOND,,,9,39,48,28,0.000031
Drama,,,1093,41,1134,8,0.001392
Insane Clown Posse,,,120,117,237,51,0.000278
Linkin Park,,,128,105,233,12,0.000242
Heterosexual,,,148,43,191,40,0.000305
Explosm,,,6,41,47,22,0.000034
Xbox Live,,,40,77,117,49,0.000064
Yu-Gi-Oh!,,,103,116,219,28,0.000151
Statistics,,,103,40,143,8,0.000243
Rap,,,262,159,421,35,0.000437
Kewlies,,,158,39,197,13,0.000272
THE BEST,,,215,65,280,9,0.000487
Troll's Remorse,,,301,36,337,41,0.000334
Food,,,151,58,209,52,0.000269
Banned,,,1567,161,1728,24,0.001832
MapleStory,,,36,221,257,34,0.000077
No life,,,353,40,393,60,0.000302
Snafu Comics,,,9,67,76,21,0.000022
Hot,,,125,6,131,52,0.000161
Skript kiddie,,,284,56,340,10,0.000348
Denial of Service,,,225,39,264,10,0.000309
Notepad,,,41,32,73,10,0.00006
KILL IT WITH FIRE,,,448,36,484,22,0.00081
Klarawagner,,,13,33,46,36,0.000085
Ghetto,,,190,23,213,35,0.000236
Ninja,,,131,71,202,49,0.000168
Guitar Hero,,,52,90,142,12,0.000062
Military,,,85,98,183,37,0.000173
Girlfriend,,,184,67,251,36,0.00026
RuneScape,,,92,146,238,49,0.000392
Drug,,,1063,217,1280,35,0.001631
Trey Burba,,,24,51,75,9,0.000058
Britney Spears,,,149,76,225,36,0.000283
Kurt Cobain,,,118,43,161,12,0.000209
Portal,,,142,115,257,49,0.000239
Half-Life,,,67,63,130,49,0.00009
Fred,,,66,93,159,61,0.000105
Rules of the Internet,,,120,52,172,9,0.000177
Straight Edge,,,51,68,119,12,0.000132
Orgy,,,272,32,304,36,0.000313
Modern Warfare 3,,,18,168,186,49,0.000026
You're/Your,,,93,27,120,3,0.000369
Xbox,,,199,51,250,49,0.000234
Attention Deficit Hyperactivity Disorder,,,189,16,205,34,0.000232
MySpace Kid,,,7,27,34,12,0.000026
DaxFlame,,,45,77,122,48,0.000117
Newbie,,,961,41,1002,9,0.001524
Pretty cool guy,,,398,118,516,49,0.00062
C-NOTE,,,18,21,39,49,0.000031
Fag,,,1422,7,1429,33,0.001827
Steam,,,118,54,172,49,0.000138
CS,,,2,4,6,10,0.00002
Never,,,130,19,149,13,0.000166
Exploding Van,,,36,26,62,9,0.000061
Offended,,,394,16,410,6,0.000568
Transformers,,,128,155,283,34,0.000251
Saw,,,29,81,110,22,0.000086
Politics,,,208,35,243,14,0.000403
This Looks Shopped,,,124,11,135,9,0.000226
Adobe® Photoshop®,,,482,49,531,9,0.000695
Transvestite,,,181,34,215,63,0.00025
Condom,,,131,57,188,36,0.000278
This is why we can't have nice things,,,45,79,124,25,0.000064
Redneck,,,695,94,789,35,0.000888
Wigger,,,458,68,526,12,0.00067
Oxymoron,,,237,76,313,35,0.000385
Internet Fuckwad Theory,,,11,14,25,41,0.000027
Not gay,,,316,50,366,40,0.000525
Bright Neon Nike Shirt,,,9,21,30,35,0.000035
Hypothetical-Kun,,,1,10,11,53,0.000019
I'm 12 years old and what is this?,,,126,30,156,9,0.000119
Immature,,,30,47,77,24,0.000054
Mark Foley,,,71,57,128,14,0.000203
Republican,,,467,124,591,14,0.000806
Michelle Lyn Taylor,,,6,27,33,4,0.000025
Prostitute,,,519,44,563,36,0.000689
Shotacat,,,49,14,63,53,0.000088
Soulja Boy,,,69,76,145,12,0.00014
Is Your Son a Computer Hacker?,,,11,60,71,10,0.00003
Molest,,,127,15,142,53,0.000173
The Cancer That Is Killing /b/,,,563,137,700,9,0.000803
Ultraviolet News Network,,,13,52,65,2,0.000031
Scientology,,,721,235,956,26,0.001211
Ahmed Mohamed,,,5,13,18,37,0.000022
Angry German Kid,,,40,70,110,28,0.000057
BodyXPolitic,,,11,24,35,48,0.00003
BrandontheMovieGuy,,,4,44,48,34,0.000022
Clayranger89,,,13,122,135,32,0.000048
Cheddar-Cheesia,,,10,54,64,34,0.000027
DJ SkeptiK,,,12,46,58,8,0.000033
Dog264,,,7,30,37,48,0.000024
Dragongirl66,,,11,79,90,41,0.000028
YTMND,,,156,35,191,9,0.00035
Flameviper,,,6,49,55,2,0.000021
Flardox,,,16,118,134,24,0.000044
HTS-Noob,,,15,32,47,4,0.000067
Jawsus,,,32,82,114,48,0.000082
JoshU2uber,,,31,126,157,40,0.000162
Katherine Marion,,,10,65,75,42,0.000022
Maarten,,,4,20,24,58,0.000019
Mitchell Henderson,,,132,92,224,58,0.000205
League of Legends,,,32,151,183,49,0.000056
76chan,,,6,64,70,9,0.000026
Sam Leeson,,,6,47,53,5,0.000022
Youngconservative,,,2,59,61,14,0.00002
YouTube Poop,,,100,96,196,34,0.000141
Instagram,,,90,29,119,59,0.000205
Snapchat,,,20,32,52,59,0.000034
Bible,,,293,136,429,46,0.000564
Flipnote Hatena,,,13,102,115,40,0.00003
Garry's Mod,,,46,78,124,49,0.00008
Habbo Hotel,,,168,114,282,9,0.000333
Soldier Of Fortune II,,,3,38,41,4,0.000021
Tumblr,,,498,190,688,19,0.000802
World of Warcraft,,,325,140,465,49,0.000535
Fortnite,,,2,7,9,49,0.000019
Skill,,,97,9,106,10,0.00015
Ghey,,,180,18,198,0,0.000487
AOL speak,,,7,3,10,10,0.000063
AFK,,,20,16,36,18,0.00004
Keyboard,,,18,38,56,10,0.000077
Ramen,,,30,50,80,57,0.000076
G2g i need sleep,,,20,13,33,3,0.000073
Gb2,,,41,21,62,9,0.000181
GTFO,,,827,25,852,27,0.001178
Gaia Online,,,241,198,439,9,0.000448
Brb,,,33,28,61,48,0.000087
"Brb, soup",,,62,51,113,9,0.000146
Chris Forcand,,,71,62,133,26,0.000191
Robert Hawkins,,,26,81,107,58,0.000076
Heath Ledger,,,71,83,154,40,0.000158
Candlejack,,,55,17,72,9,0.000149
Delicious Cake,,,352,76,428,9,0.000754
Old meme,,,480,99,579,9,0.001041
Patriotic Nigras,,,73,62,135,31,0.000146
W00t,,,6,10,16,3,0.000038
Life,,,138,244,382,46,0.000302
The Simpsons,,,168,98,266,34,0.000349
Greece,,,133,132,265,37,0.000286
Myg0t,,,14,58,72,49,0.00004
Gosu,,,2,6,8,49,0.000028
StarCraft,,,84,108,192,49,0.000173
B1FF,,,7,9,16,10,0.000039
Padonki,,,4,34,38,10,0.000032
U413,,,17,154,171,10,0.000056
HACKERS ON STEROIDS,,,165,53,218,26,0.000262
Recursion,,,7,0,7,46,0.000046
English,,,208,45,253,37,0.000454
Microsoft,,,221,18,239,10,0.000355
14/f/Cali,,,19,13,32,50,0.000049
California,,,259,100,359,35,0.000325
ASL,,,26,11,37,3,0.000071
Spam,,,513,51,564,64,0.000556
No girls on the internet,,,155,47,202,4,0.000307
E (prefix),,,15,39,54,8,0.000057
Pain Series,,,423,20,443,6,0.000724
16-year-old Japanese schoolgirl,,,29,16,45,28,0.000077
Otaku,,,179,41,220,28,0.000235
Cybersex,,,216,37,253,31,0.000245
80-year-old Chinese man in panties,,,76,27,103,28,0.000212
Ohbutyouwillpet,,,59,39,98,39,0.000156
Perverted-Justice,,,37,57,94,43,0.000179
Jew Gold,,,690,26,716,17,0.000819
Hard Gay,,,49,60,109,28,0.000082
Trap-kun,,,24,46,70,40,0.000086
Nevada-tan,,,24,49,73,22,0.00005
Angst,,,161,49,210,12,0.0002
One Direction,,,16,147,163,63,0.000037
Altcaps,,,14,20,34,64,0.000044
Anti-lulz,,,387,80,467,1,0.000788
99.9%,,,78,20,98,28,0.000233
Weblog,,,400,47,447,48,0.000696
Fan sign,,,8,13,21,8,0.000034
PROTIP,,,378,22,400,26,0.000683
Forum,,,339,165,504,3,0.000537
IS IT CAN BE HUGS TIEM NOW PLEES?,,,7,3,10,9,0.000032
OtakuWorks,,,4,80,84,40,0.000024
Trying too hard,,,470,105,575,7,0.000562
Maturity,,,43,48,91,21,0.000065
Skrillex,,,14,5,19,12,0.000033
Swag,,,42,84,126,12,0.000072
Ignored,,,62,25,87,27,0.000154
Chav,,,172,121,293,42,0.000287
MS Paint,,,336,27,363,21,0.000484
Self Injury,,,313,132,445,12,0.000549
Eating disorder,,,82,36,118,52,0.000179
Danielspengies,,,20,80,100,48,0.000034
Indie,,,108,125,233,12,0.000133
Deadmau5,,,12,21,33,12,0.000032
Pro-Ana,,,366,106,472,52,0.000668
Stfu,,,390,46,436,27,0.000518
Iceland,,,36,65,101,37,0.000106
The Hunger Games,,,16,120,136,0,0.000041
Inception,,,29,44,73,34,0.00006
Donnie Darko,,,9,38,47,12,0.000032
Martin Ssempa,,,27,26,53,40,0.000054
Africa,,,356,115,471,35,0.000668
Large Hadron Collider,,,61,129,190,46,0.000125
Vagoo,,,1490,81,1571,39,0.002391
Sock puppet,,,639,78,717,2,0.0007
Wikipedia Porn,,,38,33,71,2,0.00015
Homeschooling,,,10,28,38,46,0.000029
Cheerleader,,,6,43,49,59,0.000026
Idiot,,,774,31,805,55,0.000839
Cops,,,492,101,593,35,0.000577
Iraq,,,254,128,382,37,0.000422
China,,,594,191,785,11,0.001054
Insane,,,1736,176,1912,30,0.001883
Hell,,,335,28,363,46,0.000622
Mormon,,,301,150,451,46,0.000531
McDonald's,,,245,78,323,41,0.000459
O rly,,,454,60,514,48,0.000688
Blow,,,18,4,22,15,0.000041
Murder,,,493,238,731,27,0.000822
Nigra,,,385,46,431,35,0.000647
Bebo,,,40,55,95,3,0.000092
Epilepsy,,,101,8,109,12,0.000137
Art,,,261,62,323,31,0.000316
Hott,,,177,42,219,2,0.000329
The Great Black Dick Hoax,,,149,55,204,63,0.000258
"IDK, my BFF Jill?",,,21,16,37,21,0.000052
Shitty art,,,188,62,250,21,0.000146
Homestar Runner,,,24,66,90,1,0.000093
I Came,,,281,39,320,39,0.000523
Tease Pics,,,7,97,104,8,0.000074
Crystal Shinkle,,,22,58,80,48,0.000045
Bitches and whores,,,49,77,126,36,0.000137
Boxxy,,,157,152,309,9,0.00034
I TOUCHED HIS PENIS!! OMG,,,13,90,103,27,0.000057
Katy,,,19,22,41,9,0.000038
OMG,,,296,53,349,57,0.000499
Sleepy-kyuubi,,,4,20,24,21,0.000024
Wannabealoserr,,,3,20,23,35,0.000042
Houston,,,20,51,71,35,0.000077
2005,,,162,42,204,8,0.000696
Sharking,,,19,14,33,39,0.00013
161,,,4,24,28,9,0.000013
OP,,,176,6,182,9,0.000457
List of *chan boards,,,38,60,98,9,0.000065
Noko,,,4,10,14,9,0.000018
Epic Win,,,1156,66,1222,32,0.001559
LURK MOAR,,,96,8,104,9,0.0002
B/tard,,,285,56,341,9,0.000442
Cancer,,,650,65,715,9,0.000844
Jews,,,2356,243,2599,17,0.003672
Holocaust,,,616,97,713,17,0.001029
1772 Society,,,3,43,46,37,0.000016
Rhode Island,,,14,102,116,0,0.000021
Justin Catalano,,,5,37,42,37,0.000022
Before the internets,,,29,48,77,37,0.000055
Children,,,377,63,440,13,0.000551
DDR,,,46,86,132,40,0.000074
Drunk,,,237,52,289,37,0.000239
Conservatism,,,374,220,594,14,0.000526
College,,,305,138,443,11,0.000413
Dear Sister,,,10,15,25,9,0.000029
Comments,,,58,22,80,8,0.000115
Tolerance,,,15,47,62,14,0.000032
Freedom,,,82,31,113,37,0.000166
France,,,490,250,740,37,0.001018
Ryan Bilodeau,,,2,9,11,37,0.000011
Revolution,,,23,8,31,37,0.000035
Dream,,,14,13,27,59,0.000023
History,,,82,33,115,37,0.000159
Hate mail,,,19,36,55,64,0.000035
Courtney Catalano,,,4,4,8,37,0.00002
18-1,,,33,22,55,9,0.000079
UNITIИU,,,11,19,30,9,0.000025
Card Crusher,,,31,35,66,9,0.000094
Boston,,,60,128,188,35,0.000087
ATHF Terrorist Attack,,,28,68,96,35,0.000051
Censorship,,,194,61,255,2,0.000268
The Game,,,330,56,386,49,0.00056
Why So Exploitable,,,12,43,55,9,0.000025
Advice Dog,,,153,64,217,9,0.000295
Handegg,,,89,39,128,35,0.000152
Manti Te'o,,,10,55,65,0,0.000034
Sp/,,,51,107,158,9,0.000103
Rax Grissman,,,10,37,47,9,0.000026
Cindy Crosby,,,11,40,51,32,0.000018
Superbowl XXX,,,10,22,32,9,0.000032
TheAmazingAtheist,,,167,104,271,46,0.000498
1942,,,2,14,16,37,0.000012
Nazi,,,1283,171,1454,37,0.001719
Pegging,,,59,25,84,40,0.000165
Columbus,,,3,11,14,35,0.000012
List of sex moves,,,185,111,296,39,0.000314
1980s,,,156,79,235,12,0.000236
Mystery Science Theater 3000,,,38,61,99,61,0.000119
Nutshell,,,18,13,31,28,0.000025
Douchebag,,,502,67,569,0,0.000587
Spics,,,370,61,431,35,0.000402
Rachel Marsden,,,61,25,86,2,0.000096
Ronald Reagan,,,97,66,163,14,0.000175
BBC,,,70,105,175,17,0.000114
Super Dimension Fortress Macross,,,8,38,46,28,0.000018
Money,,,710,90,800,17,0.00102
Morrissey,,,43,45,88,12,0.000091
Budd Dwyer,,,39,58,97,58,0.000103
Crossfire (board game),,,2,0,2,37,0.000013
Millennials,,,67,162,229,19,0.000076
Love,,,245,96,341,50,0.000288
Psychopath,,,265,67,332,30,0.0003
Just Because,,,19,15,34,46,0.000029
Opioids,,,140,77,217,12,0.000236
Stoner,,,95,94,189,34,0.000151
Teenage Mutant Ninja Turtles,,,46,86,132,34,0.000075
Dragon Ball Z,,,206,162,368,28,0.000287
DuckTales,,,6,41,47,17,0.000016
Rumor,,,33,3,36,8,0.000096
J-Pop,,,39,37,76,28,0.000103
Gary Coleman,,,20,1,21,37,0.000031
Columbine,,,316,138,454,58,0.000431
Soviet Canuckistan,,,554,144,698,37,0.00088
Hugh Hefner,,,11,36,47,18,0.000083
Batman,,,237,161,398,34,0.000333
Vietnam,,,109,76,185,37,0.000254
Seth MacFarlane,,,24,59,83,34,0.000043
Madonna,,,53,48,101,36,0.000114
Pittsburgh,,,24,135,159,35,0.000031
Metallica,,,65,109,174,12,0.000148
Metal (music),,,107,167,274,12,0.000159
X-men,,,30,13,43,34,0.000043
Necrophilia,,,272,74,346,22,0.00045
Time,,,42,17,59,53,0.000164
1990s,,,137,76,213,58,0.000155
Big Brother,,,133,72,205,37,0.000233
Psion Guild,,,37,50,87,27,0.000066
"Shut Up, Little Man!",,,6,13,19,11,0.000104
Bill Clinton,,,120,73,193,19,0.000295
Eternal September,,,42,39,81,10,0.000092
AOL,,,130,49,179,10,0.000295
Steve Jobs,,,107,90,197,10,0.000182
PlayStation,,,152,74,226,49,0.000166
Nintendo 64,,,15,111,126,49,0.000031
Timothy McVeigh,,,28,96,124,58,0.000042
Serbia,,,78,40,118,37,0.000138
Baruch Goldstein,,,5,30,35,58,0.000021
Premenstrual Tension,,,68,25,93,13,0.000062
School Shooting,,,122,211,333,58,0.000174
The Great Habbo Raid of July 2006,,,52,83,135,9,0.000178
Matthew Shepard,,,12,39,51,40,0.000034
Wyoming,,,13,31,44,35,0.000031
Dying alone,,,511,248,759,7,0.00081
Detroit,,,122,148,270,35,0.000189
Doopie DoOver,,,70,141,211,53,0.000202
AerisDies,,,6,14,20,9,0.00002
Final Fantasy VII,,,112,142,254,29,0.000208
Glenn Beck,,,120,125,245,14,0.000288
Osaka,,,7,33,40,28,0.000023
Duke Nukem Forever,,,46,117,163,49,0.000102
Monica Lewinsky,,,23,54,77,19,0.000068
2008,,,283,119,402,48,0.00044
The War of Northern Aggression,,,39,89,128,35,0.000083
2000s,,,13,207,220,58,0.000032
World War I,,,42,29,71,37,0.000081
World War II,,,244,97,341,37,0.0004
Vaporwave,,,18,12,30,12,0.000032
The Google,,,658,165,823,10,0.001051
2010s,,,16,149,165,58,0.000035
1Girl99Stomps,,,3,21,24,37,0.000017
Dialup,,,20,22,42,10,0.000029
Fantasy,,,64,34,98,46,0.000085
X Y is X,,,155,43,198,9,0.000234
In Soviet Russia...,,,128,98,226,37,0.000229
The Lion King,,,39,118,157,31,0.000055
Bad Vlad,,,113,125,238,37,0.000162
Preved,,,5,15,20,37,0.000015
3Guys1Hammer,,,69,43,112,22,0.000132
1 for all,,,1,15,16,37,0.000011
Aboriginal,,,95,66,161,35,0.000182
Slavery,,,323,55,378,35,0.000433
Genocide,,,117,71,188,37,0.000224
Islam,,,762,304,1066,37,0.001429
EDiot,,,255,87,342,48,0.000439
Torture,,,109,42,151,37,0.000177
Ron Paul,,,160,215,375,14,0.00027
1chan,,,10,40,50,31,0.000018
YouTube Thomas Club,,,24,106,130,7,0.000038
F40PH,,,36,32,68,9,0.000045
Conspiracy Theory,,,385,118,503,17,0.000487
Germany,,,291,105,396,37,0.00062
Old people,,,722,102,824,6,0.001219
Jew York City,,,316,86,402,35,0.000459
Dat Ass,,,121,40,161,49,0.000193
Spellcheck,,,83,42,125,3,0.000143
New Zealand,,,78,70,148,59,0.000143
United States of Australia,,,514,222,736,59,0.000943
Midget,,,180,37,217,63,0.000236
Josef Fritzl,,,257,148,405,39,0.000465
Creepy,,,84,34,118,50,0.0001
Texas,,,220,126,346,35,0.000276
Alaska,,,41,34,75,35,0.000076
Job,,,148,113,261,35,0.000225
AuroraFurries,,,15,73,88,31,0.000031
Jay Naylor,,,21,117,138,31,0.000039
1guy1jar,,,76,36,112,6,0.000146
1guy1jar Interview,,,3,13,16,6,0.000015
Shock Site,,,107,82,189,6,0.00027
Internet celebrity,,,465,194,659,8,0.000543
2girls1cup,,,162,40,202,22,0.000301
In the ass,,,489,9,498,0,0.001043
Stick It In Her Pooper,,,106,21,127,39,0.000373
Sea Kittens,,,16,57,73,25,0.000043
I accidentally X,,,128,19,147,9,0.000196
House,,,155,148,303,9,0.000299
EFukt,,,11,52,63,6,0.000022
Ukraine,,,41,328,369,37,0.000111
TheForum,,,8,125,133,6,0.000018
Zombies Make me Hot,,,3,28,31,8,0.000014
Foreskin,,,37,52,89,17,0.000088
Luka Magnotta,,,69,70,139,25,0.000123
Rectal foreign body,,,3,14,17,6,0.000032
Brenda Williams,,,12,94,106,5,0.000076
Sound Docking,,,43,43,86,40,0.000084
BDSM,,,576,66,642,39,0.000779
Eel girl,,,22,6,28,6,0.000085
2009,,,265,145,410,48,0.000629
Hypercube,,,6,74,80,64,0.000023
DracoGuard,,,56,122,178,31,0.000098
1guy1knee,,,5,30,35,22,0.000021
Leonard Nimoy,,,3,15,18,33,0.000014
The Big Bang Theory,,,33,110,143,7,0.000124
Totse,,,36,121,157,4,0.000093
Sacha Baron Cohen,,,86,65,151,41,0.000139
MIT,,,19,75,94,11,0.000057
Beck,,,4,2,6,26,0.000017
Mega ultra super genius,,,226,40,266,11,0.000229
Girlvinyl,,,294,56,350,52,0.000677
A/,,,67,52,119,28,0.000092
R9gay,,,93,115,208,9,0.00021
Steve Irwin,,,81,81,162,3,0.000152
Aurora Theatre Shooting,,,53,65,118,58,0.000085
Jizztini,,,23,13,36,20,0.00009
Two Girls One Finger,,,6,12,18,22,0.00002
1justin,,,8,8,16,8,0.000038
LJ user,,,70,14,84,8,0.000158
Misoconfused,,,2,8,10,8,0.000016
RSS,,,7,12,19,41,0.000019
1tabita,,,1,15,16,8,0.00002
EPIC,,,481,61,542,32,0.000517
Put Shoe On Head,,,70,58,128,8,0.000155
I Am Legend,,,18,25,43,9,0.000027
Forced Meme,,,425,187,612,9,0.000727
2-J,,,1,31,32,50,0.000011
Yellow fever,,,25,131,156,28,0.00005
Website,,,94,5,99,2,0.000131
I did it for the lulz,,,850,160,1010,1,0.001389
Chat,,,81,38,119,3,0.000211
Mujahideen Video,,,129,46,175,37,0.000172
Fun,,,67,29,96,5,0.000069
Best Korea,,,203,151,354,37,0.000321
The Spanish Inquisition,,,22,37,59,37,0.000059
Waaaambulance,,,353,35,388,5,0.000329
2/10 Would Not Bang,,,8,4,12,9,0.000015
Image Macro,,,115,33,148,9,0.000417
I'D HIT IT!,,,63,35,98,9,0.000068
2003,,,33,21,54,58,0.000053
2011,,,223,138,361,59,0.000454
Web 2.0,,,230,49,279,2,0.000402
NORP,,,311,61,372,7,0.000436
W,,,586,149,735,14,0.001429
White guilt,,,110,56,166,35,0.000147
Y2K,,,42,28,70,3,0.000055
PlayStation 2,,,39,81,120,49,0.00005
Gamecube,,,29,57,86,49,0.000036
2001,,,28,15,43,58,0.00004
Jeb Bush,,,25,34,59,19,0.000056
Florida,,,179,92,271,35,0.00022
Prison,,,348,94,442,39,0.000492
Saudi Arabia,,,48,158,206,37,0.000072
Newgrounds,,,157,13,170,4,0.000227
Shawn Woolley,,,10,61,71,49,0.00002
Apple,,,345,149,494,10,0.000527
Patriot Act,,,28,43,71,14,0.00004
Serial Killers,,,80,100,180,22,0.000157
2002,,,26,17,43,58,0.000044
Kingdom Hearts,,,76,118,194,28,0.000082
Robert Steinhäuser,,,18,33,51,58,0.000028
Saddam Hussein,,,77,76,153,37,0.000192
Star Wars Kid,,,21,22,43,33,0.000056
Operation Pipe Dreams,,,6,17,23,53,0.000014
2004,,,52,40,92,58,0.0001
EverQuest II,,,70,227,297,49,0.000103
Numa numa,,,38,26,64,52,0.000052
Nawlins,,,127,68,195,35,0.00022
Confederate States of America,,,88,135,223,35,0.000138
George Bush doesn't care about black people,,,73,67,140,35,0.000211
Blockland,,,20,131,151,58,0.000026
Attack of the Show,,,12,60,72,0,0.000019
Super Columbine Massacre RPG,,,14,25,39,58,0.000033
Jeff Weise,,,50,152,202,58,0.000136
SheezyArt,,,58,59,117,21,0.000132
Xbox 360,,,118,165,283,49,0.00014
Leeroy Jenkins,,,36,18,54,49,0.000047
Chuck Norris,,,126,59,185,13,0.000314
Loose Change,,,25,37,62,17,0.000076
Placentafag,,,178,138,316,26,0.000275
Brokeback Mountain,,,49,15,64,40,0.000087
2006,,,241,145,386,8,0.000561
Bantown,,,139,83,222,41,0.000306
Meatspin.com,,,129,41,170,6,0.000253
My Immortal,,,125,160,285,12,0.000168
National Emo Kid Beatdown Day,,,8,15,23,12,0.000031
Mad Mel,,,90,65,155,37,0.000226
Don Vito,,,5,33,38,58,0.000014
Kimveer Gill,,,28,34,62,58,0.00006
Lonelygirl15,,,22,42,64,48,0.000037
Lulzcon,,,22,11,33,1,0.000104
ShutdownED.org,,,9,42,51,24,0.000015
Ted Haggard,,,49,67,116,46,0.000122
YouTube Civil War,,,11,23,34,48,0.00002
Crossmack,,,51,47,98,48,0.000064
2007,,,298,160,458,58,0.00058
The Great Sonic-cide of 2007,,,27,95,122,21,0.000073
300,,,240,78,318,9,0.000398
The Great Re/b/oot,,,12,32,44,9,0.000034
Tay Zonday,,,153,88,241,9,0.000305
Computer Science III,,,341,77,418,10,0.000488
Rickroll,,,233,75,308,9,0.000315
Cho Seung-Hui,,,132,64,196,58,0.000157
The Great LiveJournal Strikethrough of 2007,,,18,56,74,8,0.000034
Pekka-Eric Auvinen,,,53,104,157,58,0.000115
Tyler Dumstorf,,,16,63,79,58,0.000028
Alex Wuori,,,56,66,122,26,0.000134
Buy A Dog,,,202,70,272,26,0.000292
INTERNET HATE MACHINE,,,297,34,331,26,0.000302
The Great Habbo Raid of July 2007,,,18,42,60,32,0.000056
The Great Deathly Hallows IRL Raid of 2007,,,8,31,39,58,0.000026
Krystal Can't Enjoy Her Sandwich,,,45,76,121,31,0.000064
Barack Hussein Obama,,,421,2,423,14,0.00116
The Anti-ED-Club,,,15,65,80,21,0.000025
Minneapolis Bridge Collapse,,,18,70,88,53,0.000046
Minnesota,,,34,72,106,35,0.000066
Don't Taze Me Bro,,,56,59,115,14,0.00007
East High School Salt Lake City,,,14,26,40,39,0.000035
Jock,,,92,54,146,58,0.000115
Asa Coon,,,17,57,74,58,0.000023
No Cussing Club,,,42,117,159,34,0.00006
The Great LiveJournal Buyout of 2007,,,9,15,24,8,0.000022
PROJECT CHANOLOGY,,,216,62,278,26,0.000445
PROJECT CHANOLOGY/IRL PROTEST PAGE,,,12,12,24,26,0.000032
Super Smash Bros,,,114,284,398,49,0.00015
Krystal,,,47,24,71,31,0.000064
The Great LiveJournal Content Strike of 2008,,,9,88,97,8,0.000023
Hagger,,,27,35,62,2,0.000037
Operation LIONCASH,,,35,76,111,9,0.000094
Olympic Flame,,,13,132,145,11,0.000045
Dongcopter,,,57,30,87,49,0.000106
THUNDERDOME,,,27,89,116,26,0.000025
Second Life,,,156,79,235,31,0.000212
Old /b/ Day,,,16,81,97,9,0.000044
Shamwow,,,60,83,143,9,0.000113
Dorian Thorn,,,72,13,85,8,0.000636
Oprah Winfrey,,,124,67,191,35,0.000282
Bailout Plan,,,72,95,167,17,0.00015
Epic Sword Guy,,,28,35,63,26,0.000051
Emo Cutter Girl,,,16,34,50,12,0.000055
Sandalgate,,,16,97,113,14,0.000073
Satan Claus,,,37,87,124,58,0.000074
Nancy Pelosi,,,32,25,57,14,0.000053
God Hates Fags,,,296,180,476,40,0.00067
Kenny Glenn The Animal Abuser,,,60,147,207,25,0.000092
Travis the Killer Chimp,,,17,56,73,35,0.000039
Girugamesh,,,42,57,99,9,0.000062
John Katehis,,,5,18,23,48,0.000015
Angry Homo Kid,,,67,112,179,40,0.000196
Tony48219,,,13,65,78,46,0.000026
Tubcat,,,14,160,174,52,0.000056
Operation YouTube,,,16,49,65,26,0.000023
BILLY MAYS,,,116,100,216,9,0.000241
Balloon Boy,,,21,68,89,22,0.000049
Fort Hood,,,24,80,104,58,0.000038
ED5,,,12,61,73,8,0.000048
Tiger's Wood,,,33,46,79,39,0.000041
Feltcho,,,26,25,51,41,0.000041
Apocalypse,,,63,78,141,46,0.0001
President,,,93,88,181,14,0.000147
John Titor,,,12,17,29,41,0.000018
Space,,,74,94,168,46,0.000098
EverQuest,,,68,246,314,49,0.000112
Ellen Feiss,,,11,24,35,8,0.000036
Eminem,,,86,74,160,12,0.000212
Friendster,,,16,15,31,12,0.000036
Tom Anderson,,,31,39,70,12,0.000071
Nerd,,,706,93,799,10,0.000982
Ripper,,,101,34,135,1,0.000232
John Kerry,,,39,43,82,14,0.000099
Los Angeles,,,200,73,273,35,0.000319
Leftard,,,319,77,396,14,0.000543
Terri Schiavo,,,73,34,107,14,0.000115
EA,,,58,65,123,49,0.00006
Livecorpse,,,8,15,23,4,0.000027
Pulling a Lynndie,,,19,13,32,37,0.000074
To Catch A Predator,,,19,48,67,59,0.000036
Mark Zuckerberg,,,43,51,94,17,0.000058
Half-Life 2,,,40,45,85,49,0.000045
Grand Theft Auto: San Andreas,,,3,31,34,18,0.000015
Gwen Stefani,,,13,51,64,28,0.000041
Raid,,,255,116,371,26,0.000354
FurAffinity,,,247,189,436,31,0.000308
Joseph Evers,,,43,16,59,48,0.000076
Gentlemen,,,142,102,244,9,0.000313
Burning Man,,,20,48,68,46,0.000057
The Secret,,,5,43,48,17,0.000033
Poor,,,441,67,508,35,0.000615
XP,,,3,6,9,10,0.000033
Extreme,,,95,72,167,39,0.000203
Liberalism,,,481,256,737,14,0.00085
HNNNNNNGGGGG,,,116,50,166,9,0.000213
Ted Stevens,,,72,85,157,53,0.000187
Srsly,,,710,47,757,49,0.000982
Fred Bauder,,,55,40,95,2,0.000063
Madrigalskylark,,,5,20,25,8,0.000016
Thoseskinnygirls,,,3,98,101,52,0.000034
EBaumsworld.com,,,194,106,300,26,0.000304
Art theft,,,76,70,146,28,0.000054
Jakejekyll,,,10,19,29,51,0.000025
Crazayjillay,,,4,11,15,36,0.000019
Baby,,,140,80,220,1,0.00024
Djfox,,,5,23,28,21,0.000014
Jacknstock,,,38,22,60,2,0.000095
Done with ED,,,30,67,97,52,0.000034
Cosplayfucks,,,10,35,45,8,0.000026
David Shadle,,,2,5,7,63,0.000014
Dwarlinggirlxcore,,,11,30,41,39,0.000026
3000th Article,,,5,21,26,6,0.00003
Andrewpants,,,24,32,56,8,0.000061
Mediacrat,,,89,100,189,8,0.000303
Christopher Walken,,,15,28,43,12,0.000038
Rubberduc,,,19,17,36,8,0.000074
Protect fucking everything,,,7,13,20,2,0.000025
Dollfie,,,32,112,144,28,0.000057
Sheneequa,,,131,42,173,35,0.000314
Tawneelynne,,,26,62,88,8,0.000105
Lebanon,,,24,81,105,37,0.00005
Israel,,,307,66,373,37,0.00055
Zenofeller,,,5,25,30,2,0.000026
Uncyclopedia,,,307,107,414,2,0.000706
Onideus Mad Hatter,,,56,182,238,52,0.000142
B/-day,,,23,55,78,9,0.00005
Culturalbaggage,,,8,58,66,5,0.000026
Tfo,,,23,14,37,52,0.000071
Funnelgirl,,,33,24,57,22,0.000079
Littlefag,,,7,55,62,3,0.00002
Malerymalamute,,,6,9,15,31,0.000025
Alexis Valoran Reich,,,15,60,75,63,0.000042
DannyRose,,,11,32,43,31,0.000019
Cripples,,,177,39,216,38,0.000224
Prince Jeremy,,,76,117,193,31,0.000163
Hans Reiser,,,12,28,40,10,0.000026
Dramacrat,,,64,8,72,8,0.000125
RFJason CL Experiment,,,21,28,49,41,0.000034
Robert Levin,,,49,105,154,41,0.000128
Wikipedophile,,,193,79,272,2,0.000404
Cast Fetish,,,9,5,14,39,0.000025
Chasethehedgehog,,,92,123,215,21,0.000097
Cyclotouriste,,,4,33,37,41,0.000046
Edit war,,,64,17,81,2,0.000094
Lulz News Network,,,21,14,35,8,0.000103
Jake Brahm,,,39,64,103,9,0.000101
OldDirtyBtard,,,83,66,149,26,0.000207
Buzzboard,,,6,31,37,3,0.000018
PeppermintPatti,,,44,65,109,48,0.000111
YouTube Street Team,,,19,27,46,48,0.000034
Argent009,,,67,131,198,48,0.000091
Gay God,,,27,86,113,40,0.000046
Kramer,,,40,28,68,35,0.0001
Fundamentalist,,,160,90,250,46,0.000253
OJ Simpson,,,102,73,175,35,0.000257
Rupert Murdoch,,,62,97,159,14,0.000121
Djdlikesxbox,,,5,23,28,48,0.000017
Bravesgirl5,,,14,55,69,48,0.000073
Because of Parkinson's,,,40,21,61,49,0.000043
IPhone,,,110,91,201,10,0.000298
Girl on the Internet Syndrome,,,199,124,323,7,0.00021
Feminism,,,547,184,731,39,0.001247
Andrew Erickson,,,9,14,23,53,0.000026
Ray Jones,,,42,86,128,31,0.000096
Megan Meier,,,65,105,170,41,0.000132
The Caturday Nap,,,22,63,85,9,0.000045
Anna Nicole Smith,,,55,66,121,36,0.000106
Firedarkdragon,,,14,74,88,31,0.00003
Greg Solomon,,,16,35,51,48,0.000021
Renetto,,,42,103,145,48,0.000055
Knuffy,,,17,120,137,38,0.00003
Lulzcast,,,12,17,29,19,0.00008
Randi Harper,,,58,102,160,19,0.000096
TheRedSkull,,,49,90,139,48,0.000089
7chan,,,162,88,250,9,0.000256
Filthywhore,,,14,26,40,48,0.000022
Lostpedia,,,6,27,33,1,0.000016
Wattage,,,24,49,73,48,0.000062
Blu Aardvark,,,54,67,121,2,0.000102
The Promised Land,,,67,26,93,48,0.000097
Realm-Of-The-Shadows,,,5,96,101,46,0.000014
Tumbles the Stairdragon,,,23,40,63,31,0.00004
Warbears,,,25,161,186,16,0.000065
YouTube Vigilantes,,,19,47,66,48,0.000034
CircaRigel,,,15,48,63,48,0.000042
Irish282,,,59,66,125,48,0.000096
Thedramatube,,,29,55,84,48,0.000035
Chevy the Therapy Dog,,,11,23,34,31,0.000099
Essjay,,,38,67,105,2,0.000062
Kenneth Eng,,,22,45,67,11,0.000035
Max Day,,,10,14,24,9,0.000028
Michael Crook,,,8,79,87,38,0.000021
Fatferaligatr,,,24,42,66,31,0.000034
KurtBatz,,,16,59,75,31,0.000046
Micha Armstrong,,,8,54,62,40,0.000025
Todd Goldman,,,18,25,43,21,0.000066
Pigslop,,,30,44,74,48,0.000032
BLANKING IN PROGRESS,,,100,17,117,24,0.00011
Chris Benoit,,,96,117,213,0,0.000186
Dustin Diamond,,,10,42,52,52,0.000032
Johnnyr,,,4,12,16,54,0.000021
SokiTwopaw,,,17,51,68,31,0.000032
Synnergy,,,3,47,50,52,0.000015
GoddessMillenia,,,36,124,160,47,0.000088
Inflatablewolfi,,,21,34,55,31,0.000032
Mary Moon,,,14,38,52,55,0.000022
Sonic CulT,,,11,51,62,5,0.000021
XxPrincessPunkxx,,,24,110,134,12,0.000066
Aeverine Nieves,,,15,85,100,48,0.000033
DMCA,,,158,59,217,48,0.000223
AngelofthyNight,,,13,226,239,41,0.000019
BitingBeaver,,,81,102,183,26,0.00016
Applemilk1988,,,59,146,205,48,0.000118
HellionExciter,,,15,49,64,48,0.000023
LittleCloud,,,64,130,194,21,0.000206
Michelle Madigan,,,8,21,29,10,0.000025
Owen Wilson,,,11,30,41,61,0.000026
WHEN I WAS,,,78,111,189,9,0.000152
KCFireplug,,,17,100,117,8,0.000052
Vanessa Hudgens,,,27,85,112,36,0.000052
CryptoKids,,,16,52,68,38,0.000026
The Man,,,498,66,564,35,0.000601
Douglas L Payne Jr,,,15,69,84,10,0.000054
Pwnest Peters,,,11,52,63,9,0.000038
Kendricks Redtail,,,2,44,46,31,0.000014
SFW Porn,,,26,26,52,9,0.000083
Swirl Face,,,50,69,119,39,0.000173
Anuebunnie,,,6,46,52,1,0.000023
Clementine,,,3,28,31,39,0.000016
Sean Taylor,,,5,48,53,35,0.000019
Jeff Gerstmann,,,8,22,30,49,0.000017
Pull Your Pants Up,,,8,17,25,40,0.000021
Yinepusayi,,,6,26,32,8,0.000023
"Brb, compromised",,,45,78,123,9,0.00005
Andrew Greissman,,,2,9,11,9,0.000014
Anonymuncule,,,4,42,46,9,0.000016
Benazir Bhutto,,,8,65,73,37,0.000023
GoddessMine,,,34,70,104,26,0.000054
Nghtmrchld26,,,16,133,149,46,0.000039
Jamie Lynn Spears,,,10,60,70,36,0.000029
Jarrad Willis,,,16,51,67,9,0.000021
Gothefuckaway,,,3,45,48,21,0.000014
Lord of the Rings,,,141,52,193,46,0.000176
Intellectual Checkmate,,,121,125,246,48,0.000311
SnowVhite,,,15,92,107,48,0.000028
Tatiana the Tiger,,,25,35,60,60,0.000048
Carlos Sousa Jr,,,21,83,104,60,0.000054
ED,,,709,21,730,48,0.001211
Snugglenet,,,6,3,9,26,0.00002
Olympics,,,32,44,76,11,0.00005
Catnarok,,,76,30,106,25,0.00014
"Paul ""Fetch"" Carnes",,,77,31,108,48,0.000145
War,,,198,94,292,37,0.000286
LILSHOWSTOPPA,,,4,14,18,48,0.000014
PROJECT CHANOLOGY/IDES OF MARCH,,,13,27,40,26,0.000034
Megaman,,,77,95,172,49,0.000091
So i herd u liek mudkip,,,359,122,481,9,0.000745
Marcab Confederacy,,,60,63,123,26,0.0001
SUPERCOOLWILLOW,,,8,35,43,48,0.000021
Codey Porter,,,35,54,89,58,0.000083
Gemma Anscomb,,,7,89,96,32,0.000016
Billoon45,,,19,34,53,48,0.000041
EQ2Flames,,,52,230,282,49,0.000089
PROJECT CHANOLOGY/OPERATION RECONNECT,,,2,10,12,26,0.000018
Anabelle Lotus,,,35,65,100,51,0.000083
Adam Savage,,,23,33,56,41,0.000078
Age of Conan,,,16,56,72,49,0.000026
Kirtaner,,,24,26,50,9,0.000044
SWATting,,,67,50,117,26,0.00011
Desperate,,,153,103,256,40,0.000156
PROJECT CHANOLOGY/OPERATION SEA ARRRGH,,,9,22,31,26,0.000024
4chan.js,,,27,71,98,9,0.000038
DisneyFan01,,,45,116,161,21,0.000068
Mary Alice Altorfer,,,15,34,49,9,0.000042
Chanocalypse Naow,,,17,55,72,9,0.000042
Daniele Fiorenza,,,19,50,69,9,0.000026
LOLympic Games,,,11,190,201,11,0.000026
Sceptre,,,82,174,256,2,0.000154
Zerg Rush,,,155,40,195,49,0.000336
South Ossetia,,,35,170,205,37,0.000072
Spore,,,13,79,92,49,0.000026
An Halo,,,13,40,53,58,0.00004
ByAppointmentTo,,,17,63,80,2,0.000041
Gov.palin@yahoo.com,,,19,115,134,9,0.000038
Sarah Palin,,,157,177,334,14,0.000355
MTV,,,88,57,145,12,0.000183
Forumwarz,,,13,96,109,41,0.000032
Losttrap,,,10,34,44,9,0.000041
Brandon Crisp,,,21,98,119,58,0.000032
Saint Hill,,,6,21,27,26,0.000018
CandyJunkie,,,18,48,66,1,0.000051
Senator Barack Hussein Obama,,,25,144,169,35,0.000553
DBoyWheeler,,,34,145,179,21,0.000044
Got my girlfriend to model for my car,,,13,56,69,9,0.000052
IChan,,,7,30,37,9,0.00002
Docs,,,606,101,707,48,0.000505
Blagogate,,,23,68,91,35,0.000052
Shit that will never happen,,,53,85,138,19,0.000066
JuggaletteJenny,,,27,72,99,48,0.000036
An Negro,,,4,26,30,35,0.000027
CrusaderCat,,,20,71,91,31,0.000043
Zalgo,,,48,28,76,9,0.000063
The Dan Lirette Story,,,15,159,174,36,0.000034
Animal abuse,,,92,96,188,25,0.000148
Cheyenne Cherry,,,27,38,65,25,0.000052
Camille Marino,,,13,59,72,25,0.000023
Esachasa,,,19,69,88,49,0.000056
Pollfest,,,7,10,17,8,0.000017
Casual Friday,,,10,16,26,52,0.000021
Agent Pubeit,,,19,71,90,26,0.000029
EXTREME ANIMALS,,,27,79,106,9,0.000086
Faggot Bruce,,,11,21,32,40,0.00004
Jett Travolta,,,6,59,65,26,0.000023
Mark Gormley,,,10,33,43,48,0.000027
Illinois,,,28,92,120,35,0.000026
Dan144x,,,17,84,101,21,0.000025
Octomom,,,18,58,76,36,0.000063
Tabula Rasa,,,17,85,102,49,0.000028
Sup Dawg,,,107,186,293,9,0.000148
Brittany Holechko,,,30,154,184,7,0.000066
Skype,,,86,34,120,48,0.000059
Egg Girl,,,9,49,58,9,0.000029
I am disappoint,,,131,51,182,9,0.000148
Get On IRC Fgt,,,49,17,66,52,0.000096
Jade Goody,,,19,77,96,36,0.000054
Louise Ogborn,,,10,73,83,39,0.000046
PIFTS.exe,,,13,46,59,10,0.000032
I GOT NORTON!,,,48,25,73,10,0.000136
Space Bat,,,7,11,18,9,0.000028
Watchmen,,,55,135,190,9,0.000092
Dick Neck,,,41,73,114,4,0.00011
Swine Flu,,,69,200,269,35,0.000124
CIA,,,143,41,184,37,0.00026
Kari Ferrel,,,14,63,77,35,0.000023
The R Word,,,19,83,102,38,0.000079
This is the second notice that the factory warranty on your vehicle is expiring,,,8,23,31,9,0.000023
Creepy Chan,,,18,55,73,9,0.000028
Dreamwidth,,,7,56,63,8,0.000019
Mattmurderface,,,10,84,94,21,0.000018
Taking Down ED,,,120,152,272,48,0.000112
Beccah Beushausen,,,6,36,42,2,0.000018
Brad McQuaid,,,18,84,102,49,0.000035
Drp1zza,,,11,120,131,48,0.000031
Left 4 Dead,,,47,195,242,49,0.000064
TsimFuckis,,,55,75,130,9,0.000118
WhatPort80,,,9,49,58,48,0.000033
A Clockwork Orange,,,15,22,37,9,0.000033
AT&T Blocks 4chan,,,19,26,45,10,0.000038
Crimson-Silvrblood,,,10,65,75,21,0.00004
EVE Online,,,41,155,196,49,0.000061
The Real Chris-chan,,,29,71,100,7,0.000047
Creepy Phil,,,13,71,84,32,0.000053
EDF 2: Electric Boogaloo,,,113,131,244,52,0.00012
Liskula Cohen,,,10,74,84,36,0.000033
Rootbrian,,,66,183,249,48,0.000107
Brain,,,44,25,69,34,0.000072
Aion: The Tower of Eternity,,,11,121,132,49,0.00002
Imma Let You Finish,,,48,119,167,9,0.000075
Operation Fat Fuck,,,6,47,53,26,0.000018
Tammi Reynolds,,,5,14,19,7,0.000024
Zaiger,,,71,121,192,52,0.000095
Alexander Stern,,,7,30,37,49,0.000018
Alyssa Bustamante,,,13,40,53,39,0.000032
Brandon Hilton,,,13,90,103,40,0.000022
Evony,,,15,52,67,49,0.000026
MyIDIsPhat,,,6,28,34,48,0.000016
Rifqa Bary,,,3,30,33,37,0.000016
Roman Polanski,,,25,91,116,17,0.00004
TrollsOfTerror,,,7,88,95,32,0.000023
Ae-tan,,,25,46,71,2,0.000054
Aeralik,,,11,29,40,49,0.000021
Ashley Towns,,,5,63,68,26,0.000019
Desuchan,,,24,73,97,9,0.000053
New York Yankees,,,23,48,71,35,0.000072
Superlisamcb,,,9,116,125,35,0.000034
Teruchan,,,57,114,171,28,0.000133
Foxy Knoxy,,,11,106,117,36,0.000024
Chanology Contest,,,4,26,30,26,0.000015
Frosty the Snowman,,,9,29,38,19,0.000023
Dustin Michaels,,,8,40,48,40,0.000071
Portia Allen,,,2,23,25,51,0.000014
BBWChan,,,27,45,72,52,0.000084
2010,,,285,175,460,41,0.000321
Food Not Bombs,,,10,71,81,14,0.00004
Steve Hodder-Watt,,,10,50,60,35,0.000023
Dramasetter,,,4,13,17,49,0.000013
Ellie Light,,,5,44,49,14,0.000014
Firefox XPS IRC Attack,,,18,24,42,41,0.000065
Gay Nigger Association of America,,,217,46,263,41,0.0004
Freenode,,,42,33,75,41,0.000074
Hæti,,,68,87,155,35,0.000116
IPad,,,34,79,113,10,0.00007
Mill Park Tree,,,12,42,54,1,0.000034
Polandball,,,28,28,56,37,0.000032
Krautchan,,,17,129,146,37,0.000026
Shadow,,,16,100,116,26,0.000032
Weev,,,193,88,281,41,0.000373
Angie The Atheist,,,5,22,27,46,0.000017
Abortion,,,446,141,587,46,0.000626
Mickyy Moo,,,17,29,46,9,0.000052
Epic Beard Man,,,67,54,121,9,0.0001
Facebook Login,,,5,36,41,10,0.000018
Fat Man,,,4,89,93,52,0.000014
Grace Saunders,,,25,75,100,15,0.000041
Jim Bunning,,,9,11,20,14,0.000019
Nodar Kumaritashvili,,,3,30,33,11,0.00002
Operation Titstorm,,,22,73,95,26,0.000089
Pennsylvania Pedo Cam,,,3,13,16,53,0.000014
Robot Unicorn Attack,,,67,23,90,9,0.000068
VampiricSpektor,,,35,83,118,27,0.00006
Cyberbu//y,,,57,32,89,41,0.000093
Verizon,,,8,40,48,10,0.000028
STOFlames,,,7,3,10,49,0.000016
Alexis Pilkington Syndrome,,,10,69,79,41,0.00003
Angel Locsin,,,3,17,20,35,0.000013
Philippines,,,78,141,219,35,0.000137
Australian Media ED Interview,,,4,9,13,41,0.000016
Cheeseburger Josh,,,11,28,39,39,0.000034
Christian Spanking Blogs,,,22,77,99,39,0.000075
Deeker,,,19,73,92,22,0.000044
Dogo Nahawa Massacre,,,4,15,19,46,0.000023
Gorgeous George,,,34,113,147,61,0.000098
Kimmo Johan Alm,,,66,74,140,9,0.00015
Health Care Rage,,,18,61,79,14,0.000024
Parry Aftab,,,8,36,44,41,0.000027
Quiptxt Day,,,3,30,33,10,0.000015
Real Life Super Hero,,,10,42,52,31,0.000022
Trololo,,,32,14,46,9,0.000122
Derek Smart,,,13,45,58,49,0.000022
Boobquake,,,11,39,50,39,0.000019
"Alan ""Brenlo"" Crosby",,,13,43,56,49,0.000024
Deepwater Horizon,,,32,98,130,14,0.000067
Fergie Olver,,,9,37,46,39,0.000026
Fucking Magnets,,,99,34,133,51,0.000142
Kate's Party,,,16,52,68,41,0.000074
KFC Double Down,,,10,25,35,52,0.000023
Iceland Volcano 2010,,,11,68,79,37,0.00002
Ministry of Lol,,,7,6,13,41,0.000018
MissHannahMinx,,,26,107,133,28,0.000058
Pandas,,,17,26,43,53,0.000064
Polish Lollercaust,,,18,51,69,37,0.000023
Poland,,,148,132,280,37,0.000416
Sniffer,,,4,27,31,9,0.000013
Rainbow Blinkies,,,19,15,34,10,0.000076
South Park,,,245,235,480,34,0.000475
Revolution Muslim,,,7,28,35,37,0.000028
The Human Centipede,,,42,79,121,22,0.000098
Tennessee,,,27,56,83,35,0.000037
Lost,,,48,151,199,1,0.000046
DUN DUN,,,34,118,152,19,0.000068
Catherine Deveny,,,6,27,33,41,0.000015
DrMusic2,,,44,164,208,7,0.000114
Everybody Draw Mohammed Day,,,38,70,108,37,0.00006
Freedom Flotilla,,,14,95,109,37,0.000024
Lawrence Taylor,,,7,19,26,39,0.000015
Operation Dusty Trail,,,3,11,14,26,0.000013
Hayley Williams,,,12,43,55,12,0.000019
Death Note,,,122,108,230,28,0.000203
The Unabrower,,,4,19,23,37,0.000012
MysticArk,,,13,46,59,7,0.000028
Aaron Williams,,,11,70,81,15,0.000017
Are You Serious?,,,10,82,92,35,0.000019
Callum Stockley,,,2,35,37,44,0.000012
Cheer Up Keanu Day,,,28,61,89,9,0.000062
Derrick Bird,,,9,26,35,58,0.00002
England,,,338,225,563,37,0.000599
G20 Toronto Lollercaust,,,10,28,38,37,0.000016
Goatse Security,,,22,30,52,41,0.000039
Lyor Cohen,,,20,113,133,35,0.000028
Kevin Rudd,,,30,58,88,14,0.000046
Vuvuzela,,,25,54,79,60,0.000027
Boo,,,6,25,31,42,0.000023
Blizzard Entertainment,,,32,27,59,49,0.000046
Real ID,,,14,55,69,49,0.000054
Faust and Pory,,,11,75,86,52,0.000037
Gawker Media,,,105,189,294,19,0.000168
Adrian Chen,,,12,60,72,41,0.000019
Gloria Tesch,,,12,123,135,21,0.000029
Operation Earl Grey,,,8,32,40,26,0.000018
Paul,,,8,19,27,60,0.000029
Raoul Moat,,,8,59,67,58,0.000021
World Cup 2010,,,21,193,214,60,0.000037
Alvin Greene,,,10,36,46,14,0.000019
Antoine Dodson,,,20,34,54,39,0.00004
Bincat,,,9,37,46,25,0.000028
ED Singers,,,19,12,31,52,0.000029
Disgraced Encyclopedia Dramaticians,,,29,82,111,2,0.000036
Spaghettios,,,29,77,106,39,0.000051
Andrew Shirvell Loves Chris Armstrong,,,4,82,86,14,0.000013
Hack is Wack!,,,15,46,61,35,0.000034
Haunted Majora's Mask Cartridge,,,10,53,63,9,0.000017
Puppy Pitcher,,,14,44,58,25,0.000022
Tyler Clementi,,,10,25,35,58,0.000021
William J. Lashua,,,8,20,28,9,0.000015
Final Fantasy XIV,,,19,94,113,49,0.000035
Eingee.com,,,6,24,30,49,0.000024
Imperial Stars,,,19,80,99,35,0.000032
Slowpoke,,,110,26,136,9,0.000159
The Rent Is Too Damn High,,,11,32,43,13,0.000018
Giants Riot,,,2,12,14,35,0.000012
The Troll Hunter,,,12,41,53,7,0.000055
WikiLeaks,,,104,158,262,19,0.000175
David Tanny,,,17,102,119,38,0.000036
VenomFangX,,,68,87,155,46,0.000145
Hipster,,,536,130,666,12,0.000669
Yiff,,,488,74,562,31,0.000613
Pedophilia apologia,,,20,27,47,19,0.000194
Mass Shooting,,,47,56,103,58,0.000073
Social Justice,,,594,148,742,19,0.000783
WWIII,,,45,66,111,37,0.000073
Arab Spring,,,12,60,72,37,0.000036
Libya,,,21,55,76,37,0.000029
Syria,,,60,56,116,37,0.00008
3D Printer,,,1,2,3,58,0.000011
Charlie Hebdo,,,24,107,131,37,0.000029
San Bernardino Shooting,,,9,89,98,37,0.000028
Boston Marathon Bombing,,,28,103,131,37,0.000053
Gun control,,,62,203,265,58,0.00006
Jared Lee Loughner,,,20,51,71,58,0.000051
Anders Behring Breivik,,,102,100,202,58,0.000126
Chris Harper-Mercer,,,31,45,76,58,0.000034
Dmitry Vinogradov,,,13,38,51,58,0.000022
Dylann Storm Roof,,,38,83,121,58,0.000051
Aaron Alexis,,,9,41,50,58,0.000033
Elliot Rodger,,,110,92,202,58,0.00016
TJ Lane,,,20,45,65,58,0.00005
2012 GNAA Tumblr Ruin,,,9,18,27,41,0.00008
Cut4Bieber,,,16,30,46,41,0.000038
SANDYLOOTCREW,,,18,12,30,41,0.000028
M00t's GamerGate Sellout,,,20,88,108,19,0.000036
8chan,,,109,96,205,19,0.000125
GamerGate,,,228,147,375,19,0.000256
Brony,,,442,192,634,7,0.000977
CopperCab,,,42,121,163,23,0.000096
Japan Crisis of 2011,,,19,97,116,28,0.000032
Nyan Cat,,,28,147,175,16,0.000049
Osama bin Laden,,,173,93,266,37,0.000308
LulzSec,,,46,71,117,10,0.000107
Snitch,,,55,17,72,10,0.000102
Jackass,,,57,38,95,34,0.000073
Weinergate,,,23,47,70,14,0.000055
Anal Cunt,,,22,22,44,12,0.000115
Occupy Wall Street,,,72,82,154,14,0.000148
Stop Online Piracy Act,,,31,109,140,14,0.000076
Francesco Schettino,,,8,56,64,9,0.000023
Joseph Kony,,,30,96,126,0,0.000054
2012 Elections,,,23,176,199,14,0.000087
Amanda Todd,,,55,61,116,58,0.000098
Golden iPod,,,50,134,184,58,0.000083
Sandy Hook Elementary Massacre,,,89,160,249,58,0.000199
Aaron Swartz,,,10,37,47,58,0.000026
Chris Dorner,,,22,84,106,58,0.000059
San Francisco,,,141,97,238,11,0.000247
OhInternet,,,195,67,262,52,0.000381
2014,,,209,87,296,19,0.000233
Monica Punk,,,15,97,112,27,0.000063
OpFerguson,,,56,94,150,35,0.000098
James Foley,,,12,24,36,37,0.000028
Robin Williams,,,26,33,59,19,0.000072
Zoe Quinn,,,160,207,367,19,0.000202
ED10,,,5,57,62,52,0.000032
2015,,,183,100,283,19,0.000153
Leelah Alcorn,,,26,38,64,19,0.00003
Muhammad Sex Simulator 2015,,,14,31,45,37,0.000022
Freddie Gray,,,9,16,25,35,0.00002
Shitskin Plantation,,,82,37,119,35,0.000119
Maryland,,,45,35,80,35,0.000056
Jared Fogle,,,26,47,73,19,0.000055
Rapefugee,,,52,59,111,37,0.000089
Zika,,,5,26,31,35,0.000015
Hulk Hogan,,,37,42,79,15,0.000057
Hulk Hogan's Sex Tape Scandal,,,3,20,23,19,0.000014
Brexit,,,31,74,105,19,0.000039
2017,,,214,223,437,19,0.000269
William Atchison,,,48,74,122,58,0.000082
2018,,,127,67,194,19,0.000157
Logan Paul,,,11,24,35,48,0.000017
Marjory Stoneman Douglas School Shooting,,,28,54,82,58,0.000041
711chan,,,50,151,201,9,0.000073
DJ KEEMSTAR,,,51,178,229,1,0.000052
The Great Egyptian Riot of 2011,,,7,69,76,37,0.000019
4chon.net,,,20,39,59,9,0.000048
Puella Magi Madoka Magica,,,16,104,120,28,0.000025
Co/,,,50,129,179,34,0.000077
AHS,,,3,32,35,28,0.000016
Atimon,,,17,132,149,1,0.000041
Fort Longcat,,,13,33,46,31,0.000023
Drawrawr,,,5,59,64,7,0.000025
Duty Calls,,,4,4,8,49,0.000015
Rebecca Black,,,34,95,129,12,0.000067
Nichole337,,,6,38,44,32,0.000015
DestinyMew,,,21,79,100,21,0.000029
Ryan,,,28,24,52,10,0.000073
Operation Restoration,,,12,19,31,52,0.000035
PlayStation 3,,,115,89,204,49,0.000128
LurkMoarpedia,,,5,23,28,32,0.000016
LifeInATent,,,76,156,232,36,0.000241
Tornadoes,,,10,71,81,35,0.000018
AnonOps,,,37,43,80,10,0.000142
The Rapture,,,71,85,156,46,0.000112
Randy Savage,,,8,17,25,15,0.000019
Dominique Strauss-Kahn,,,5,48,53,39,0.000027
DreamHost,,,17,28,45,8,0.000028
Michael Horowitz Foster,,,17,21,38,9,0.000029
Codenamesailorearth,,,7,12,19,28,0.000017
Dong,,,85,8,93,37,0.000199
Ev0,,,9,25,34,10,0.000022
Tom Preston,,,116,146,262,19,0.000137
WeatherManKevin,,,22,69,91,36,0.000049
GreenReaper,,,26,58,84,31,0.00006
Equivamp,,,9,100,109,31,0.000018
WikiFur,,,61,81,142,31,0.000105
Ralph Squillace,,,9,23,32,2,0.000031
Wikicide,,,45,78,123,2,0.000052
Daniel Brandt,,,67,68,135,2,0.000112
Meepsheep,,,36,19,55,2,0.000057
Norway,,,80,75,155,37,0.000151
Amy Winehouse,,,58,95,153,36,0.000096
Richard Symonds,,,18,32,50,2,0.000031
Conservapedia,,,72,154,226,46,0.000194
Frank Garrett,,,9,18,27,41,0.000016
KrappleGuy,,,12,79,91,7,0.000017
Furry Paws,,,10,175,185,16,0.000015
UK Lootfest 2011,,,17,59,76,35,0.000026
Gizgiz,,,9,38,47,31,0.000019
Tablecow,,,17,57,74,7,0.000033
Taekesi,,,14,75,89,32,0.000018
Longseet,,,5,117,122,24,0.000016
Adf-fuensalida,,,46,109,155,7,0.00007
Bungie.net,,,7,33,40,49,0.000021
Cigarsex,,,17,8,25,52,0.000038
Chris-chan/People,,,49,191,240,7,0.000072
DO NOT PUBLISH... THIS IS A TEST,,,3,1,4,63,0.000014
Doe Deere,,,5,71,76,24,0.000022
Felice Fawn,,,4,51,55,1,0.000015
Forever Alone,,,295,48,343,7,0.00033
Great iPhone 4S disappointment of 2011,,,7,39,46,10,0.000017
Italian Wikipedia,,,4,17,21,2,0.000016
MyAdopts,,,11,75,86,44,0.00002
Bad Dragon,,,45,53,98,31,0.00009
Muammar Gaddafi,,,20,84,104,37,0.000042
Xenophiles,,,11,32,43,31,0.000038
Judge William Adams,,,13,104,117,39,0.000026
Tails gets trolled,,,16,136,152,21,0.000025
Bill9929,,,14,43,57,32,0.000048
Kelseyalicia,,,6,86,92,26,0.000022
John Pike,,,12,43,55,26,0.000019
Arrow to the knee,,,25,5,30,49,0.000047
SheWolf,,,9,67,76,39,0.000032
Paul Christoforo,,,4,34,38,49,0.000015
Penny Arcade,,,37,69,106,1,0.000088
Deaths in 2011,,,1,14,15,37,0.000013
2012 (year),,,8,85,93,2,0.000085
"December 21, 2012",,,14,60,74,46,0.000108
London Olympics,,,16,106,122,6,0.000116
Fukushima 2012,,,19,47,66,13,0.000086
Katawa Shoujo,,,19,137,156,28,0.000046
Pickbothmanlol,,,8,28,36,2,0.000015
FimFiction,,,7,16,23,7,0.000016
Trayvon Martin,,,67,103,170,35,0.000103
Mlp/,,,20,36,56,7,0.000035
Niggest Crook Force,,,22,28,50,7,0.000035
Rizon,,,11,12,23,41,0.000025
Tomska,,,7,18,25,19,0.000015
Mershed Perderder,,,11,83,94,9,0.000022
Rubén Puig Lecegui,,,6,37,43,7,0.000015
Beefrave,,,15,38,53,52,0.000032
Sir Billi,,,9,79,88,37,0.000017
North Britain,,,125,137,262,37,0.00023
Th3j35t3r,,,15,23,38,10,0.000053
Doxbin,,,20,34,54,10,0.000025
Barrett Brown,,,11,19,30,10,0.000022
Heidi Crowter,,,34,48,82,9,0.000067
Qwyrxian,,,5,18,23,2,0.000013
Meatpuppet,,,4,13,17,2,0.00002
Hipcrime,,,16,43,59,2,0.000046
Oliver Keyes,,,27,32,59,2,0.000073
The Spoony Experiment,,,33,119,152,61,0.000054
That Guy With The Glasses,,,97,109,206,61,0.000113
Zeekill,,,17,31,48,10,0.00002
Lulznet,,,20,38,58,9,0.000027
Tsukihi,,,6,12,18,41,0.000015
Howard Stern,,,50,98,148,41,0.000071
Adalia Rose,,,28,45,73,38,0.00006
Former Bureaucratic Fucks,,,17,94,111,2,0.000028
Broadside,,,6,76,82,14,0.000013
Wade Michael Page,,,3,45,48,58,0.000013
India,,,313,158,471,37,0.00052
Ecce Mono,,,4,11,15,9,0.000018
Diego Grez,,,9,21,30,2,0.00003
Grumpy Cat,,,23,23,46,25,0.000084
Jimmy Savile,,,60,154,214,17,0.00012
Libertarianism,,,163,178,341,14,0.000241
Dongforce,,,21,52,73,41,0.000042
Dennis Avner,,,6,21,27,31,0.000015
Black Friday,,,5,9,14,35,0.000014
Meme Combining,,,32,47,79,9,0.000102
Ty Ziegel,,,10,42,52,37,0.000021
Afghanistan,,,111,57,168,37,0.000209
Pussy,,,964,6,970,61,0.001258
"Warhammer 40,000",,,74,247,321,22,0.000112
Mitt Romney,,,44,105,149,14,0.000088
Ralph Nader,,,11,26,37,14,0.000045
The Colbert Report,,,113,174,287,14,0.000191
Trolling IRL,,,286,198,484,37,0.000485
Iowa,,,20,31,51,35,0.000031
HAIL SATAN EVERYDAY,,,19,0,19,46,0.000045
Politically Correct,,,105,58,163,14,0.000208
Herman Cain,,,30,112,142,14,0.000047
Newt Gingrich,,,16,54,70,14,0.000022
Rick Santorum,,,84,65,149,14,0.000139
Demockery,,,57,37,94,37,0.000096
Bukkake,,,257,38,295,36,0.000386
Ball,,,301,33,334,63,0.000359
Unemployment,,,126,38,164,35,0.000131
Fake News,,,192,191,383,19,0.000383
Race Card,,,25,17,42,35,0.000032
Racism,,,657,191,848,35,0.000726
Negress,,,100,55,155,35,0.000134
NIGGER MANUAL,,,32,52,84,35,0.000102
Karl Rove,,,22,35,57,14,0.000035
Economy,,,56,107,163,17,0.000118
Paul Ryan,,,10,25,35,14,0.000018
Ayn Rand,,,73,114,187,14,0.000104
Randroid,,,44,75,119,14,0.000051
Bahrain,,,10,128,138,37,0.000023
Iran,,,152,130,282,37,0.000299
Weed,,,418,66,484,35,0.000558
Todd Akin,,,10,35,45,14,0.000015
Nevada,,,28,26,54,35,0.000057
Pennsylvania,,,50,80,130,35,0.000041
Michigan,,,48,43,91,35,0.000056
Ohio,,,94,97,191,35,0.000157
Boredom,,,449,36,485,60,0.000459
Drama bomb,,,50,142,192,8,0.000045
How is babby formed?,,,91,31,122,36,0.000147
Le Sigh,,,6,3,9,53,0.000016
Flame Wars,,,459,75,534,41,0.000858
Indiana,,,32,73,105,35,0.000041
Alex Jones,,,125,147,272,17,0.000146
Neo-con,,,72,43,115,14,0.000108
White Knighting,,,593,89,682,19,0.0004
Socialist,,,155,55,210,14,0.000234
Guido,,,208,82,290,57,0.000291
John F. Kennedy,,,91,68,159,17,0.000176
Jill Stein,,,7,9,16,19,0.000017
Welfare,,,231,75,306,35,0.000318
Too lazy,,,384,28,412,61,0.000404
Colorado,,,55,103,158,35,0.000075
Washington,,,43,86,129,35,0.000046
Arizona,,,58,75,133,35,0.0001
Cow,,,60,36,96,7,0.000097
The Clown Prince Rises,,,11,22,33,58,0.000019
Tumblr panels,,,14,50,64,9,0.000027
Cross Site Scripting,,,12,7,19,41,0.000031
Bestiality,,,648,101,749,31,0.001074
Invader Zim,,,60,51,111,21,0.000074
Futurama,,,72,99,171,34,0.000233
Fleshlight,,,98,26,124,26,0.000198
Operation AstroMoot,,,2,22,24,9,0.00002
Evolution,,,150,88,238,46,0.000278
Giovanna Plowman,,,5,32,37,39,0.000022
White trash,,,298,75,373,35,0.000393
Hero,,,121,77,198,34,0.000157
Margaret Thatcher,,,44,96,140,17,0.000086
Charles Ramsey,,,4,16,20,35,0.000027
Topkek,,,18,35,53,9,0.000113
Yes,,,267,12,279,44,0.000286
PRISM,,,10,181,191,37,0.000028
Paula Deen,,,15,35,50,52,0.000067
Flounce,,,93,22,115,8,0.000082
Scooby Werkstatt,,,5,41,46,48,0.000025
2013 US Government Shutdown,,,6,22,28,37,0.000022
HealthCare.gov,,,7,63,70,14,0.000022
SysOp,,,142,76,218,2,0.000222
Toaster Steve,,,10,29,39,9,0.000036
Tea Party,,,80,102,182,14,0.000095
Silk Road,,,19,49,68,13,0.000036
Electricity,,,16,66,82,35,0.000057
Alcohol,,,511,151,662,35,0.000842
Disease,,,79,32,111,13,0.000189
Paris Hilton,,,177,83,260,36,0.000342
Al Qaeda,,,75,34,109,37,0.000131
Bitcoin,,,40,59,99,17,0.000089
Government,,,161,58,219,37,0.000245
Sue Basko,,,19,46,65,10,0.00003
Schnookums,,,13,90,103,31,0.000017
Ragnarok,,,11,18,29,49,0.000021
Kimmy,,,7,42,49,9,0.000016
Pennsylvania School Stabbing,,,17,73,90,58,0.000028
Joseph Camp,,,14,31,45,10,0.000031
KYAnonymous,,,9,41,50,39,0.000016
OpRollRedRoll,,,17,52,69,39,0.00004
Jada,,,4,33,37,39,0.000014
Malaysia Airlines Flight MH17,,,12,39,51,37,0.000049
Dead babies,,,73,40,113,1,0.000107
Ice Bucket Challenge,,,5,28,33,19,0.000022
Kotaku,,,64,50,114,19,0.000053
Nods Respectfully Toward You,,,10,23,33,19,0.000018
Cuckoldry,,,234,59,293,19,0.000216
Phil Fish,,,32,75,107,19,0.000048
Vivian James,,,18,54,72,19,0.000026
Cathedral of Misogyny,,,9,19,28,19,0.000017
The Fappening,,,30,27,57,19,0.000056
AnonIB,,,19,119,138,0,0.000047
Gamers,,,187,76,263,49,0.000281
Leigh Alexander,,,25,77,102,19,0.000025
Jim Traficant,,,11,41,52,35,0.000053
Shahn Christian Andersen,,,5,29,34,19,0.000017
Furry art,,,87,138,225,31,0.000146
InkBunny,,,8,34,42,31,0.000016
Dragoneer,,,29,137,166,31,0.000049
Ebola-chan,,,14,39,53,19,0.000034
Ebola virus,,,32,35,67,35,0.000082
Torpark,,,71,94,165,10,0.000145
Thanksgiving,,,27,85,112,35,0.000056
The Pirate Bay,,,66,68,134,10,0.000078
The Great Torrent Raid,,,3,29,32,10,0.000015
Lizard Squad,,,11,64,75,10,0.000052
Mass Murder,,,28,22,50,58,0.000048
Laurelai,,,33,71,104,19,0.000046
"Laurelai/An Open Letter To My Rapist, Laurelai Bailey",,,2,0,2,19,0.000012
Patreon,,,82,85,167,19,0.000075
Shanley Kane,,,14,107,121,39,0.000019
Peter Coffin,,,18,136,154,19,0.000023
Imaginary girlfriend,,,64,32,96,7,0.000103
Realdoll,,,30,42,72,13,0.000048
A Man in Black,,,11,126,137,19,0.000016
Lindsay Kantha Souvannarath,,,19,63,82,58,0.000029
Hunger Games Roleplay,,,5,63,68,9,0.000013
Injuns,,,211,146,357,35,0.00036
The Great Baltimore Riots of 2015,,,11,21,32,35,0.000024
BALTIMORELOOTCREW,,,4,8,12,35,0.000015
Kill The Faggot,,,5,32,37,19,0.000015
Subway,,,14,75,89,41,0.000028
The Great Gawker Implosion of 2015,,,10,16,26,19,0.00002
Nick Denton,,,12,22,34,19,0.000019
Grand 16 Shooting,,,12,42,54,58,0.000025
"Vester Lee ""Bryce Williams"" Flanagan II",,,14,35,49,58,0.000027
Gen Zed,,,16,96,112,19,0.00002
Feminist Frequency,,,192,150,342,19,0.000214
First World Problems,,,38,79,117,19,0.000049
Joshua Goldberg,,,7,27,34,19,0.000033
Post-Teenager,,,3,44,47,7,0.000013
Kevin Johnson,,,3,18,21,14,0.000012
Ayaan Hirsi Ali,,,5,45,50,37,0.000015
Mars,,,11,26,37,46,0.000018
Cyberviolence,,,40,38,78,19,0.000032
Anton Lundin Pettersson,,,12,41,53,58,0.000024
Noah Jacob Harpham,,,5,11,16,58,0.000016
Hookers and Blow,,,282,53,335,14,0.000377
Michael Ryan,,,6,78,84,58,0.000015
ShoutYourAbortion,,,7,90,97,19,0.000015
Alt-right,,,98,60,158,19,0.000124
Angela Merkel,,,16,5,21,37,0.000052
Verified,,,10,52,62,19,0.000019
Milo Yiannopoulos,,,83,171,254,19,0.000104
The Great Dumbledore Dies Meme of 2005,,,40,43,83,8,0.000116
The Fine Bros,,,12,91,103,48,0.000018
Valentine's Day Massacre,,,8,28,36,19,0.00002
John Oliver,,,14,10,24,19,0.000039
The Current Year,,,56,53,109,19,0.000066
Turkey,,,108,173,281,37,0.000204
Fembusters,,,32,62,94,19,0.000047
Ghostbusters,,,8,13,21,61,0.000044
Belgium,,,46,94,140,37,0.000129
Pakis,,,113,81,194,37,0.000176
Alison Rapp,,,22,48,70,19,0.000048
Andrew Anglin,,,16,36,52,19,0.000022
Nazi pug,,,17,24,41,19,0.000037
Abu Hajaar,,,6,21,27,37,0.000015
ShoutYourStatus,,,10,63,73,19,0.000028
Feminist,,,411,2,413,19,0.000752
Prince,,,26,116,142,41,0.000033
Trigglypuff,,,32,71,103,19,0.000043
Evalion,,,17,66,83,19,0.000024
Onision,,,54,133,187,19,0.000063
LeafyIsHere,,,42,47,89,19,0.000039
Rodrigo Duterte,,,2,24,26,14,0.000013
Ted Cruz,,,28,81,109,14,0.000032
Gun,,,339,245,584,58,0.000606
Mike Tyson,,,26,57,83,35,0.000047
Switzerland,,,49,106,155,37,0.000089
Stephen Paddock,,,21,50,71,58,0.000033
People,,,211,78,289,13,0.00038
New Mexico,,,48,239,287,35,0.000071
Dallas Sniper Attacks,,,20,36,56,35,0.000056
Pokémon Go,,,17,93,110,19,0.000037
The Great Habbo Raid of July 2016,,,3,12,15,9,0.000017
Nice Truck Attack 2016,,,19,22,41,37,0.000034
Munich Massacre,,,19,61,80,58,0.000037
Brazil,,,112,143,255,35,0.000194
Imma-The-Deer,,,12,39,51,7,0.00002
Sam Hyde,,,25,39,64,19,0.000029
Bob8466,,,3,39,42,58,0.000015
Killer Clown Epidemic,,,5,35,40,19,0.000014
Martin Shkreli,,,9,50,59,17,0.000017
Notch,,,4,24,28,19,0.000013
Jon Sudano,,,8,26,34,19,0.000015
Somalia,,,38,31,69,37,0.000071
Ohio State University,,,9,45,54,58,0.000022
PizzaGate,,,35,221,256,19,0.000041
Logan Clark,,,5,31,36,58,0.000016
AcidChan,,,3,13,16,58,0.000014
Mevlüt Mert Altıntaş,,,6,25,31,37,0.000014
Justin-anon,,,2,12,14,58,0.000013
Kristi Winters,,,5,8,13,19,0.00002
MPAA,,,35,40,75,10,0.000038
Katelyn Nicole Davis,,,8,25,33,1,0.000054
Joey Boots,,,6,25,31,41,0.000018
Kurt Eichenbald,,,33,172,205,19,0.000062
Final Boss of the Internet,,,101,28,129,49,0.000085
George Herbert Walker Bush,,,22,41,63,14,0.000105
John Kasich,,,6,20,26,14,0.000016
Marco Rubio,,,11,28,39,19,0.000018
I'm rich and I'm beautiful,,,167,41,208,8,0.000279
Gary Johnson,,,6,11,17,19,0.000015
Atheist,,,409,284,693,46,0.000831
Robot,,,142,24,166,49,0.000141
Virus,,,100,37,137,10,0.000169
Sexting,,,29,30,59,18,0.000055
Nibiru/Planet Nine,,,9,45,54,46,0.000016
Black Lives Matter,,,99,215,314,35,0.000103
Fedora,,,111,76,187,19,0.000205
Warrior,,,1,7,8,37,0.000011
Harvard,,,30,31,61,11,0.000067
Jimbo Wales,,,257,143,400,2,0.00043
Louisiana,,,34,40,74,35,0.000062
Rick Perry,,,14,56,70,14,0.000028
Carly Fiorina,,,11,34,45,14,0.000024
New Jersey,,,107,77,184,35,0.000127
Food Pyramid,,,12,14,26,52,0.00004
Doctor,,,17,15,32,13,0.000029
Cuba,,,50,39,89,35,0.000073
The Young Turks,,,18,39,57,19,0.000029
Riots,,,42,43,85,35,0.000059
The Great Meme War,,,15,67,82,19,0.000028
Lane Davis,,,3,136,139,19,0.000012
Pepe,,,125,134,259,19,0.000278
SHUT IT DOWN,,,20,4,24,19,0.000039
Angry Goy,,,3,13,16,37,0.000012
Santa Claus,,,60,62,122,46,0.000082
Reina Nightclub Massacre,,,3,41,44,37,0.000014
Clovergender,,,4,18,22,19,0.00003
Chicago,,,68,124,192,35,0.000091
Pol/,,,142,100,242,19,0.000193
Steele Dossier,,,17,133,150,19,0.000062
BeCandid,,,12,25,37,19,0.000025
Chelsea Manning,,,15,18,33,19,0.000035
CNN,,,87,26,113,19,0.000146
Kiwi Farms,,,90,123,213,7,0.00009
Ichverbot,,,30,39,69,7,0.00004
Alexandre Bissonnette,,,4,13,17,19,0.000015
DisruptJ20,,,4,38,42,19,0.000018
Luke Crywalker,,,6,11,17,19,0.000014
AIDS Skrillex and Carl the Cuck,,,44,36,80,19,0.000054
He Will Not Divide Us,,,23,37,60,19,0.000059
Richard Spencer,,,24,58,82,19,0.00003
The Rebel Media,,,16,13,29,19,0.000039
TayTweets,,,11,51,62,19,0.00002
Electric Boogaloo,,,165,53,218,49,0.000182
Hatred (Video Game),,,26,101,127,19,0.000037
Flat Earth Society,,,17,41,58,46,0.000032
Khalid Masood's Westminster motor massacre,,,8,45,53,37,0.000017
Doctor Phil,,,27,25,52,3,0.00007
April Fools' Day,,,36,34,70,37,0.000086
Place,,,1,19,20,37,0.000012
Pool's Closed,,,199,42,241,9,0.000449
Correct the Record,,,6,17,23,19,0.00002
Pervert,,,216,20,236,53,0.000265
Robert Seman,,,6,33,39,53,0.000033
Youngstown,,,17,107,124,35,0.000044
Battle of Berkeley,,,12,25,37,19,0.000017
Postal,,,21,9,30,58,0.000031
Steve Stephens,,,12,56,68,58,0.00003
Bill Nye,,,53,89,142,19,0.000156
Bill O'Reilly,,,111,98,209,14,0.000243
DaddyOFive,,,7,36,43,48,0.000022
Cascade Mall Massacre,,,5,15,20,58,0.000018
Ariana Grande Massacre,,,11,40,51,37,0.00005
Dan Cilley,,,9,28,37,19,0.00003
London Bridge Attack 2017,,,8,17,25,37,0.000019
Randy Robert Stair,,,37,87,124,58,0.000076
Adam West,,,5,13,18,34,0.000015
The Fourteen Words,,,13,6,19,19,0.000017
Grand Theft Auto V,,,11,55,66,19,0.000027
Ramadan Van Man,,,3,38,41,37,0.000014
HanAssholeSolo,,,6,30,36,19,0.000022
Baby Boomers,,,13,17,30,19,0.000027
David Carradine,,,26,23,49,39,0.000052
Shadman,,,24,34,58,22,0.000043
Seth Rich,,,21,54,75,19,0.000021
Michelle Carter,,,1,1,2,12,0.000012
National Public Radio,,,7,64,71,19,0.000022
Las Vegas,,,51,42,93,35,0.000079
Eclipse,,,16,63,79,46,0.000037
Daily Stormer,,,18,33,51,19,0.000033
Stormfront,,,82,109,191,14,0.000119
James Alex Fields,,,10,94,104,19,0.000017
Antifa,,,57,74,131,19,0.000071
Discord,,,13,53,66,19,0.000019
CloudFlare,,,14,49,63,41,0.00002
George Soros,,,33,41,74,19,0.000037
Harvey Weinstein,,,30,73,103,17,0.000064
A challenger appears,,,182,21,203,9,0.000485
No Human Being is Illegal,,,23,52,75,19,0.000027
DACA,,,15,58,73,19,0.000017
PewDiePie,,,104,112,216,7,0.000094
St. Louis,,,11,188,199,35,0.000019
"September 23, 2017",,,6,37,43,46,0.000019
ComicGate,,,12,43,55,19,0.00002
Underrepresentation,,,35,90,125,19,0.000043
Rotten.com,,,21,35,56,6,0.000035
NeoGAF,,,59,125,184,19,0.000164
Tyler Malka,,,15,94,109,19,0.000023
Kevin Spacey,,,9,23,32,19,0.000018
The Resistance,,,12,42,54,19,0.000017
Mike Pence,,,10,31,41,19,0.000038
Autistic screeching,,,24,16,40,19,0.000032
Lame,,,285,16,301,40,0.00036
It's Okay To Be White,,,6,28,34,19,0.000022
Devin Patrick Kelley,,,6,13,19,58,0.000015
Lil Peep,,,6,33,39,12,0.000048
Al Franken,,,4,14,18,19,0.00003
Charles Manson,,,56,64,120,12,0.000111
TempleOS,,,6,14,20,10,0.000028
Jim Watkins,,,2,10,12,19,0.000013
MrRepzion,,,25,100,125,19,0.00025
Net Neutrality,,,17,94,111,17,0.000025
Filthy Frank,,,19,69,88,7,0.000031
Kwanzaa,,,14,53,67,35,0.00004
SWAuTistic,,,13,37,50,26,0.000065
2017 Saint Petersburg Metro bombing,,,2,10,12,37,0.000012
Venezuela,,,22,65,87,14,0.000029
Crapflood,,,197,43,240,10,0.000279
Coolest Monkey in the Jungle,,,9,78,87,35,0.000015
Matthew Nicholson,,,9,25,34,49,0.000088
Stephen Hawking,,,49,44,93,46,0.000117
Zombie,,,225,53,278,49,0.000313
David Hogg,,,4,34,38,19,0.000014
NXIVM,,,2,66,68,26,0.000013
George Bush,,,107,5,112,14,0.000208
Verne Troyer,,,9,28,37,13,0.000046
Kanye West,,,98,11,109,12,0.000215
Bill Cosby,,,67,165,232,19,0.000099
Totalbiscuit,,,25,90,115,19,0.000028
Maddox,,,75,172,247,19,0.000126
Dick Masterson,,,38,69,107,19,0.000086
Roseanne Barr,,,14,60,74,19,0.000057
Kate Spade,,,9,25,34,46,0.000073
DC,,,13,24,37,34,0.000032
Mikese Morse,,,8,19,27,35,0.00011
Linda Sarsour,,,7,20,27,19,0.000014
Anthony Kennedy,,,2,62,64,19,0.000014
Brett Kavanaugh,,,1,8,9,19,0.000013
Krampus,,,9,28,37,46,0.000022
2018 Russian presidential election,,,0,4,4,58,0.000011
2020s,,,5,23,28,19,0.000017
Oculus Rift,,,11,13,24,19,0.000017
Generation X,,,7,9,16,19,0.000016
Indians,,,30,2,32,35,0.000056
2064: Read Only Memories,,,0,55,55,19,0.000011
Nu-male,,,66,100,166,19,0.000101
Cringe,,,39,68,107,7,0.000028
Professional Wrestling,,,158,206,364,15,0.000219
The Walking Dead,,,6,86,92,36,0.000013
Jim Sterling,,,23,83,106,19,0.000027
Sexsomnia,,,6,18,24,39,0.000038
Special Snowflake Syndrome,,,113,58,171,7,0.000133
Neckbeard,,,305,68,373,7,0.000369
Bob Ross,,,16,18,34,9,0.000028
Motherfucker,,,51,41,92,11,0.000082
BATTLETECH (Video Game),,,4,48,52,19,0.000011
Gone Home,,,21,59,80,19,0.000018
Brianna Wu,,,99,140,239,19,0.00016
2204355,,,8,6,14,9,0.000044
Random,,,112,5,117,9,0.000205
Subservient Chicken,,,19,31,50,8,0.000043
24chan,,,7,39,46,9,0.000017
Forced anon,,,3,11,14,9,0.000025
X is not your personal army,,,310,41,351,26,0.000277
Trevorchan,,,8,26,34,9,0.000016
Drawhore,,,18,66,84,9,0.000037
Original Content,,,250,93,343,9,0.000364
Maxwell,,,1,0,1,9,0.000011
Insurgency Wiki,,,28,50,78,26,0.000093
Logic,,,187,126,313,46,0.000293
Freewebs,,,16,63,79,10,0.000027
Additional Pylons,,,15,30,45,9,0.000039
IMG!,,,5,94,99,64,0.000024
Baleet,,,292,7,299,24,0.000226
KLULZ,,,15,11,26,41,0.000068
2600,,,9,39,48,10,0.000018
Lemonparty,,,400,34,434,6,0.000634
Hacking,,,66,45,111,10,0.000081
Wal-Mart,,,176,93,269,35,0.000234
WTF,,,920,23,943,57,0.000999
Phreak,,,18,51,69,10,0.000038
Usenet,,,101,91,192,41,0.000262
Frequently Asked Questions,,,17,17,34,10,0.000046
Atari,,,38,75,113,49,0.00004
Shameless self promotion,,,153,52,205,48,0.000233
27,,,6,13,19,9,0.000015
Ban fucking everyone,,,41,23,64,9,0.000043
288chan,,,3,24,27,9,0.000041
Flash,,,123,70,193,4,0.000145
G/,,,40,52,92,9,0.000055
Hentai,,,469,90,559,28,0.000752
I/,,,100,85,185,9,0.000171
Guro,,,310,74,384,22,0.000491
The Chemo That Is Curing /b/,,,73,22,95,9,0.000119
Kyle Forrest,,,2,13,15,48,0.000012
Craigslist,,,112,63,175,41,0.000226
28DaysLater,,,2,54,56,37,0.000013
Pikeys,,,8,16,24,37,0.00002
Wales,,,70,97,167,37,0.000151
STD,,,227,45,272,36,0.000395
404 Error,,,81,21,102,9,0.000095
Image Hosting,,,63,62,125,8,0.000088
Furniture Porn,,,8,12,20,39,0.000036
Dancing on the Internet,,,24,38,62,37,0.000033
Bale Out,,,9,26,35,61,0.000022
Piss,,,300,33,333,22,0.000434
2B2T,,,5,13,18,20,0.000013
Minecraft,,,148,251,399,20,0.000219
Dub the Dew,,,12,11,23,9,0.00003
Fitmc,,,1,18,19,20,0.000012
Hugbox,,,343,29,372,7,0.000368
Roblox,,,35,123,158,20,0.000113
2Pac,,,19,17,36,12,0.00006
Sheeeit Nigger,,,12,19,31,35,0.000044
Lil B,,,46,80,126,12,0.00006
Officer Ricky,,,11,44,55,0,0.000025
P Diddy,,,10,75,85,35,0.000016
RapMusic.com,,,9,84,93,12,0.000022
2 Chainz,,,3,31,34,12,0.000012
Georgia,,,42,19,61,35,0.000048
YOLO,,,23,42,65,12,0.000027
Nicki Minaj,,,24,10,34,12,0.000028
Watermelonz,,,56,29,85,35,0.00011
Chikins,,,283,62,345,35,0.000466
Nothing,,,192,2,194,13,0.00019
OFWGKTA,,,28,190,218,12,0.000042
2 gryphon,,,21,102,123,31,0.000043
Norm MacDonald,,,12,39,51,1,0.000019
Angry Video Game Nerd,,,111,157,268,61,0.000113
Gryphon,,,6,14,20,31,0.000014
Music,,,336,213,549,12,0.000461
Dr. Steel,,,29,28,57,12,0.00008
Mind of Mencia,,,32,49,81,17,0.000099
Haters,,,98,40,138,48,0.000084
Fursuit,,,192,47,239,31,0.000293
Dickgirl,,,194,36,230,28,0.00034
Bush,,,63,14,77,14,0.000102
Crybaby,,,306,47,353,24,0.000653
Creepypasta,,,141,50,191,22,0.000222
A winner is you,,,245,47,292,58,0.000438
Screamo,,,28,88,116,12,0.000041
Amirite,,,519,18,537,0,0.00061
Portal of Evil,,,30,120,150,31,0.00004
Lurker,,,118,38,156,9,0.000241
NO U,,,357,53,410,46,0.000655
Plagiarism,,,180,25,205,61,0.000187
Snapesnogger,,,204,155,359,21,0.000253
2cash,,,1,17,18,10,0.000016
Depression,,,149,39,188,13,0.000191
Facepunch Studios,,,31,88,119,49,0.000055
2ch.ru,,,9,75,84,28,0.000017
GET,,,52,45,97,9,0.000094
2channel,,,33,19,52,28,0.000076
Memorial Page Tourism,,,44,54,98,41,0.000052
Geek,,,156,32,188,10,0.00026
Prove me wrong,,,44,17,61,9,0.000065
Brother,,,40,22,62,35,0.000036
Illegal,,,62,46,108,53,0.000094
Rozen Maiden,,,45,137,182,28,0.000099
CAPTCHA,,,21,25,46,9,0.000039
Yuri,,,50,23,73,28,0.000104
Attention,,,144,31,175,8,0.000356
Nerd Rage,,,161,65,226,26,0.000146
Cosplay,,,328,109,437,28,0.000373
Real World,,,49,26,75,3,0.000194
Xynta,,,9,14,23,37,0.000022
Natalia Poklonskaya,,,6,34,40,28,0.000019
Nyoro~n,,,21,38,59,28,0.000084
Korea,,,143,49,192,49,0.000233
Futaba Channel,,,39,15,54,9,0.000086
Moonspeak,,,236,35,271,28,0.000371
Engrish,,,245,30,275,28,0.00045
Copypaste of Vovan,,,2,5,7,28,0.000011
Russian Wikipedia,,,13,36,49,2,0.000023
Russian Lurkmore,,,15,61,76,37,0.000028
Gook,,,72,18,90,11,0.000114
Blastoise,,,12,64,76,9,0.000025
Swap.avi,,,43,20,63,22,0.000156
Roman Shower,,,78,25,103,39,0.000196
MFX Video,,,5,11,16,39,0.00002
CakeFarts,,,14,20,34,34,0.000052
Shitmeister,,,2,11,13,6,0.000032
Coprophagia,,,46,32,78,22,0.000072
2xSpeedStacksDaniel,,,2,13,15,34,0.000016
Adventure Time and Regular Show,,,9,5,14,34,0.000018
Talentless,,,40,81,121,61,0.000032
3/,,,5,15,20,9,0.000028
Teabagging,,,28,30,58,49,0.000054
Ic/,,,7,19,26,9,0.000027
Warez,,,56,27,83,10,0.000098
Neil Gaiman,,,9,63,72,36,0.000027
Mahmoud Ahmadinejad,,,38,82,120,37,0.000085
United Nations,,,58,44,102,37,0.000087
Photomanip,,,64,11,75,52,0.000143
Apples Bear,,,29,18,47,9,0.000048
Invisible X,,,24,17,41,9,0.000037
MapQuest,,,8,62,70,37,0.00002
Narutard,,,45,36,81,28,0.000048
Corey Worthington,,,19,68,87,1,0.000054
Phantom of the Opera,,,10,29,39,21,0.000022
The Power 5,,,41,24,65,6,0.00012
Rita,,,18,47,65,9,0.000042
Beowulf,,,9,72,81,54,0.000016
Deadliest Warrior,,,9,101,110,37,0.00006
God of War,,,15,149,164,49,0.000022
E-lawyer,,,266,27,293,8,0.000312
Seems Legit,,,45,18,63,9,0.000052
3999th Article,,,3,2,5,9,0.000014
4000th Article,,,4,2,6,9,0.00002
315chan,,,8,30,38,9,0.00002
Mudkipchan,,,9,18,27,9,0.000023
Sparto,,,7,25,32,9,0.000017
Moralfag,,,355,94,449,26,0.000694
Why We Protest Forums,,,48,94,142,26,0.000054
888chan,,,47,177,224,26,0.000063
"32"" Waist Chan",,,1,23,24,52,0.000013
Samefag,,,113,25,138,9,0.000139
Pixyteri,,,22,99,121,52,0.000022
Mad TV,,,43,47,90,34,0.000032
Neo-classic-neko,,,7,66,73,28,0.000027
33 Teeth,,,2,11,13,40,0.000011
LOLDONGS,,,86,34,120,54,0.000238
Fairy,,,27,10,37,49,0.000037
GovTeen,,,6,25,31,40,0.000036
Gay Teen Forum,,,17,44,61,40,0.00005
343 Industries,,,1,2,3,49,0.000011
345rv5,,,13,36,49,21,0.000025
Mario,,,233,225,458,49,0.000341
Bleach,,,91,162,253,28,0.000101
Naruto,,,240,222,462,28,0.000296
Party9999999,,,5,15,20,21,0.000023
Rad-Pax,,,4,6,10,21,0.000017
Briannabater,,,3,5,8,21,0.000015
Darth Cheney,,,99,35,134,14,0.00026
Archive.org,,,52,23,75,2,0.000064
Waluigis-girl,,,23,83,106,21,0.000027
360 Kid,,,57,88,145,9,0.000083
Okami,,,14,77,91,31,0.000022
Mortal Kombat,,,44,89,133,49,0.00009
Pikaman,,,62,62,124,9,0.00008
Gothzilla,,,44,231,275,22,0.000108
CTRL ALT Delete,,,62,116,178,1,0.000092
Trap,,,643,63,706,28,0.000845
LadyALT69,,,20,145,165,7,0.000036
Darknessthechao333,,,11,46,57,42,0.000029
Metal Gear Solid,,,112,148,260,49,0.000138
The World Ends With You,,,6,135,141,28,0.000014
HA! HA! Guy,,,51,39,90,9,0.000074
LINK MAH BOIIIII,,,121,139,260,9,0.000209
Line Trap,,,28,45,73,9,0.000059
Avatar: The Last Airbender,,,16,188,204,28,0.000027
Hank Hill,,,69,85,154,34,0.000152
Branca,,,31,208,239,21,0.000061
Amuria,,,29,52,81,21,0.00006
KawaiiNekoGirl,,,9,60,69,28,0.000021
SpleeNfat,,,15,104,119,21,0.000019
AniutqaDA,,,7,69,76,21,0.000013
Fesazukichan,,,6,58,64,12,0.000019
Street Fighter 2,,,85,183,268,49,0.000107
Woll Smoth,,,47,161,208,9,0.000099
365Black.com,,,4,30,34,35,0.000017
Hypocrisy,,,586,64,650,24,0.000511
Centipede filled vagina,,,112,43,155,39,0.000226
Basketball,,,37,73,110,35,0.000076
37,,,5,6,11,58,0.000015
Kevin Smith,,,29,70,99,34,0.000047
Tiziana Cantone,,,11,42,53,36,0.000058
3DSPlaza,,,3,13,16,9,0.000011
Shrek,,,38,22,60,7,0.000038
3GI Industries,,,7,110,117,7,0.000019
Sell Out,,,111,74,185,12,0.000147
Luser,,,385,21,406,10,0.000501
Wisconsin,,,53,78,131,35,0.000043
Poseur,,,153,26,179,12,0.000195
JFK Reloaded,,,8,25,33,49,0.000014
Theft,,,272,33,305,35,0.000334
Questionable logic,,,40,90,130,46,0.000099
Olchai,,,15,47,62,34,0.000022
"卐",,,199,5,204,37,0.000402
Hippie,,,495,104,599,14,0.000793
Bros B4 Hoes,,,12,29,41,0,0.000032
Angry Grandpa,,,14,60,74,23,0.000034
Youtube Nobodies,,,122,190,312,48,0.000109
Infantilism,,,127,67,194,7,0.0002
SammyClassicSonicFan,,,32,80,112,7,0.000044
Eric the Midget,,,8,20,28,41,0.000021
E-Psychiatrist,,,64,76,140,26,0.000154
Thinspiration,,,30,24,54,52,0.000043
In beta,,,63,19,82,19,0.000065
Star Fox,,,35,80,115,31,0.000043
No Homo,,,61,32,93,40,0.000141
Aquaphilia,,,18,53,71,22,0.000027
Twinks,,,78,29,107,40,0.00009
Copyright Infringement,,,90,36,126,61,0.000128
Fagolescence,,,13,33,46,40,0.000016
Vegan Gains,,,9,29,38,52,0.000022
Sparx Traxx,,,5,42,47,31,0.000012
Salih,,,3,26,29,37,0.000018
Limewire,,,32,25,57,53,0.000069
Bubba,,,200,36,236,39,0.000342
Headshot,,,100,29,129,58,0.000157
English Scum,,,278,97,375,42,0.000372
Bayeux Tapestry,,,47,60,107,9,0.000139
Snuff,,,38,37,75,22,0.000079
Teenage Kings of Werribee,,,16,57,73,39,0.00006
3LAMESTUDIO,,,2,32,34,7,0.000011
Vyond,,,23,41,64,34,0.000033
The Annoying Orange,,,26,37,63,0,0.000055
Five Nights at Freddy's,,,59,116,175,7,0.000097
Angry Birds,,,13,55,68,10,0.000022
Undertale,,,49,164,213,7,0.000068
Kpop,,,17,48,65,28,0.000038
Catfish,,,14,28,42,52,0.000028
Trending,,,1,2,3,19,0.000011
Fandom,,,283,87,370,21,0.0003
Let's Play,,,59,46,105,61,0.000049
3OH!3,,,5,57,62,12,0.000015
Raver,,,126,137,263,12,0.00021
Crunkcore,,,24,91,115,12,0.000043
Pabst Blue Ribbon,,,13,33,46,12,0.000025
Vegetarian,,,170,142,312,25,0.000271
BrokeNCYDE,,,26,91,117,12,0.000027
Like,,,27,22,49,29,0.000062
Too old; DO NOT WANT!,,,37,17,54,53,0.00004
"Martin Luther King, Jr.",,,53,99,152,35,0.000104
Chiptunes,,,16,35,51,12,0.000019
3chan,,,2,7,9,41,0.000014
404 Girl,,,36,40,76,9,0.000162
Database Error,,,5,16,21,10,0.000017
Mundane,,,218,24,242,31,0.000288
Azumanga Daioh,,,36,112,148,28,0.000058
Sage,,,100,24,124,9,0.000144
W. T. Snacks,,,54,29,83,9,0.000134
I go chop your dollar,,,35,18,53,64,0.000061
Oil,,,66,37,103,37,0.000159
The Fresh Prince of Bel-Air,,,196,25,221,9,0.000264
Will Smith,,,60,45,105,9,0.000114
Carlton,,,18,23,41,9,0.000044
Writing yourself into an article,,,74,30,104,2,0.000086
David Hodgkinson Lonely Hearts Victim,,,4,16,20,41,0.000017
Big Al,,,8,18,26,64,0.000024
Matt Crimmins,,,12,58,70,12,0.000031
Liek,,,34,10,44,3,0.000069
Offensive,,,65,33,98,6,0.000093
Vandalize Every Equation,,,15,28,43,2,0.00007
Chaos,,,22,32,54,13,0.000087
Dolphinsex,,,21,20,41,63,0.000068
The Hitchhiker's Guide to the Galaxy,,,8,12,20,9,0.000023
Category:Movies,,,59,0,59,22,0.000119
OL,,,130,4,134,46,0.000531
John Locke,,,33,41,74,9,0.000058
Slashdot,,,69,83,152,10,0.000171
420 (disambiguation),,,22,6,28,35,0.000035
Marijuana Addiction,,,9,39,48,35,0.000042
Epilepsy Foundation,,,14,30,44,26,0.000061
Subeta,,,23,33,56,9,0.000045
Feem,,,12,14,26,41,0.000028
Tinal,,,2,44,46,41,0.000012
X/,,,67,102,169,9,0.000099
Gore,,,82,13,95,22,0.000109
Lucky Star,,,48,123,171,28,0.000051
Wallpaper,,,14,25,39,9,0.000043
Ecstasy,,,25,38,63,12,0.000052
Shrooms,,,30,15,45,35,0.000056
Dextromethorphan,,,18,98,116,35,0.000038
Smoking,,,90,110,200,13,0.000118
Benzos,,,16,44,60,1,0.000042
Benadryl,,,6,28,34,26,0.000023
Stoned,,,82,17,99,46,0.00009
Car,,,106,154,260,37,0.000257
OM NOM NOM NOM,,,230,34,264,22,0.000388
The GIMP,,,37,31,68,21,0.000062
Comic,,,78,39,117,34,0.000085
GIF,,,68,62,130,9,0.000143
Veteran,,,219,96,315,9,0.000297
Dinosexx0r,,,32,24,56,46,0.000083
Book,,,79,42,121,46,0.000164
WebMD,,,11,34,45,52,0.000057
Philosophy,,,74,61,135,46,0.00022
Tinal/convologs,,,2,8,10,9,0.000012
Drawball,,,10,58,68,32,0.000019
Virgin Killer,,,11,26,37,2,0.000047
Anonymous Borg,,,52,74,126,9,0.000085
For great justice,,,350,19,369,56,0.000522
Stoner Guru,,,17,91,108,35,0.000038
Nightwing,,,1,40,41,9,0.000012
420chan/logs,,,1,17,18,41,0.000011
45° Celsius,,,4,4,8,9,0.000015
Albania,,,27,50,77,37,0.000062
4Kids,,,44,46,90,28,0.000057
John Hagee,,,13,31,44,46,0.000026
Kill Yourself,,,122,5,127,19,0.000222
Kirby,,,41,85,126,49,0.000063
The Money Shot,,,30,18,48,20,0.000125
One Piece,,,37,184,221,28,0.000044
Italy,,,243,112,355,37,0.000473
Magical girl,,,1,0,1,28,0.000012
Ck/,,,12,15,27,52,0.000028
FA,,,52,3,55,31,0.000102
Int/,,,18,78,96,9,0.000041
Po/,,,5,34,39,9,0.000022
Plz,,,30,17,47,8,0.000072
Qst/,,,4,20,24,9,0.000023
S/,,,9,18,27,9,0.00002
Soc/,,,9,29,38,9,0.000032
BitTorrent,,,114,111,225,10,0.00018
Tv/,,,38,81,119,7,0.000046
Wishlist,,,33,31,64,8,0.000101
Togi-chan,,,1,8,9,8,0.000018
The xchan effect,,,6,68,74,9,0.000034
NSFW,,,41,33,74,8,0.0001
Adv/,,,6,25,31,9,0.000029
Spider,,,36,37,73,25,0.000064
PayPal,,,84,40,124,8,0.000161
Kawaii,,,222,55,277,28,0.000275
EGL,,,24,52,76,28,0.000048
Cm/,,,6,52,58,28,0.000024
Diy/,,,5,12,17,9,0.000019
Fit/,,,32,39,71,9,0.00007
Butterface,,,28,36,64,19,0.000067
Rimjob,,,68,15,83,40,0.000158
Image,,,85,29,114,9,0.000161
The Doom Comic,,,24,20,44,49,0.000043
Oekaki,,,11,16,27,28,0.000022
Java,,,48,57,105,10,0.000086
Shii,,,24,36,60,2,0.000079
Birkhead,,,3,9,12,9,0.00002
N/,,,11,46,57,11,0.000024
Jp/,,,16,18,34,28,0.000044
Touhou,,,64,113,177,28,0.000142
GAR,,,14,11,25,28,0.000024
Gundam Wing,,,38,75,113,28,0.000045
Mu/,,,37,65,102,12,0.000062
Black Metal,,,76,100,176,12,0.000141
Pitchfork Media,,,23,39,62,12,0.000041
JESUS CHRIST IT'S A LION GET IN THE CAR!,,,97,34,131,31,0.000184
Webcam,,,49,27,76,8,0.000083
Intellectual,,,66,42,108,46,0.000104
Fuckyou.pl,,,63,7,70,16,0.0001
Request,,,8,8,16,9,0.000029
Rapidshit,,,26,31,57,9,0.000046
Sci/,,,11,35,46,11,0.00009
Agnosticism,,,35,39,74,46,0.000138
IQ,,,25,3,28,11,0.000047
Dungeons & Dragons,,,136,200,336,15,0.00022
Jin Saotome,,,5,28,33,34,0.000025
Into the Trash It Goes,,,16,25,41,17,0.000045
GameFAQs,,,71,74,145,49,0.000093
Stale,,,1,11,12,9,0.000018
Vp/,,,21,70,91,9,0.000032
Digimon,,,86,219,305,28,0.000129
Gardevoir,,,44,91,135,31,0.000047
Lopunny,,,22,58,80,31,0.000037
4scrape,,,5,32,37,9,0.00002
Then who was X,,,70,78,148,37,0.000102
Then A Skeleton Popped Out,,,7,15,22,9,0.000028
Killdozer,,,27,18,45,37,0.000049
Q/,,,6,19,25,9,0.000022
Random Page,,,12,2,14,9,0.000068
Z/,,,4,9,13,9,0.000023
In before X,,,44,43,87,9,0.000112
BRING BACK SNACKS,,,17,47,64,9,0.000046
Pussybitch,,,203,59,262,19,0.000375
Clippit,,,14,24,38,10,0.000042
Mantrain,,,113,29,142,40,0.000186
Sport,,,74,47,121,35,0.000127
Skateboarding,,,11,51,62,35,0.000031
Synchtube,,,4,23,27,9,0.000019
Independence Day Invasion,,,14,59,73,19,0.000038
R9k//r9k/,,,1,0,1,9,0.000018
Chanarchive,,,22,25,47,9,0.00005
Fuuka,,,4,6,10,9,0.00002
Time Magazine,,,21,57,78,9,0.000082
Rape.sh,,,6,4,10,10,0.000049
Moot is Olev,,,5,20,25,9,0.000035
July 29 Merchant broadcast,,,1,14,15,9,0.000018
4chan/WikiWorld,,,1,3,4,9,0.000018
4chan/IRC,,,2,7,9,9,0.000018
Islam Is The Light,,,5,48,53,1,0.00006
Panty & Stocking with Garterbelt,,,15,141,156,28,0.00003
Lauren Faust,,,26,106,132,7,0.000059
IP address,,,94,32,126,2,0.000111
System32,,,48,23,71,10,0.000105
HTML,,,60,25,85,10,0.000147
Art School,,,113,136,249,12,0.000185
Your resistance only makes my penis harder!,,,56,16,72,31,0.000084
Diochan,,,6,54,60,9,0.000018
Cornelia,,,7,35,42,9,0.000015
The Great ImageFap Troll,,,13,59,72,9,0.000036
Dylan Thomas,,,25,32,57,43,0.000167
Ulrichthehedgehog,,,12,88,100,61,0.000021
Cary Goulston,,,4,33,37,26,0.000018
4chan - Tumblr War,,,1,9,10,19,0.000011
Operation Overlord,,,9,65,74,9,0.000017
The Great /pol/ Social Justice Raid of 2013,,,3,35,38,19,0.000012
CIS Gender,,,32,34,66,19,0.000046
Operation Timebomb v2,,,2,15,17,19,0.000012
Magic,,,126,75,201,27,0.000176
Milhouse is not a meme,,,94,26,120,9,0.00016
Winrar,,,138,22,160,10,0.000203
Habbo /B/lockade,,,29,45,74,9,0.000081
BLT,,,5,60,65,3,0.000017
4chan Cup,,,1,23,24,9,0.000011
Tripcode,,,78,18,96,9,0.000172
4chan Ergonomics,,,3,10,13,9,0.000017
MSPaint Relationship Thread,,,18,49,67,9,0.000067
Pic Related,,,12,8,20,9,0.000052
4chan Gaming,,,5,28,33,9,0.000011
EXTREME ADVERTISING,,,71,24,95,9,0.000126
Flood detected,,,11,23,34,9,0.000016
Thurman Thomas,,,15,0,15,9,0.000032
Random Album Art,,,6,21,27,9,0.000013
Alexa,,,17,14,31,2,0.000024
Combofag,,,26,19,45,9,0.000058
Weegee,,,103,81,184,9,0.000166
Embedded files,,,8,21,29,9,0.00002
Know Your Meme,,,73,119,192,9,0.000127
4chan Phone Chat,,,1,14,15,9,0.000013
Phone number,,,15,19,34,10,0.000038
Free,,,55,14,69,10,0.000074
4chan Stencils,,,10,20,30,9,0.000044
Rules 1 and 2,,,30,46,76,9,0.000056
Operation Awesome,,,10,26,36,9,0.000017
Vandal,,,220,23,243,2,0.000266
Crimes,,,58,52,110,35,0.000109
Banksy,,,3,120,123,42,0.000013
4chan Wallpaper,,,2,115,117,9,0.000015
Diabeetus,,,183,90,273,52,0.000351
Tom Delay,,,16,19,35,9,0.000025
Taurin Fox,,,17,29,46,31,0.000028
Silent Hill,,,45,99,144,22,0.000055
Queening,,,38,26,64,39,0.0001
Queen,,,47,8,55,37,0.000101
Cowboy Bebop,,,22,43,65,28,0.00004
Ceiling Cat,,,63,40,103,25,0.000166
Limecat,,,41,47,88,9,0.000077
Garfield,,,48,78,126,61,0.000125
Loli Haet Pizza,,,9,9,18,9,0.000026
ENGLISH MOTHERFUCKER DO YOU SPEAK IT,,,152,94,246,37,0.000206
BBW,,,65,4,69,52,0.000105
Jack Sparrow,,,37,47,84,10,0.000063
Webcomic,,,136,100,236,28,0.000145
Broccoli Dog,,,16,7,23,9,0.000023
Bear Cavalry,,,9,14,23,37,0.00002
Patrick Stewart,,,39,27,66,9,0.00009
Baby Fuck,,,233,55,288,39,0.00052
MarshviperX,,,7,42,49,9,0.000023
InterWeb,,,86,10,96,32,0.000134
Klingon,,,26,18,44,33,0.000041
Gmask,,,3,20,23,53,0.000027
Piccolo Dick,,,18,21,39,9,0.000059
Surgeon,,,6,34,40,9,0.000015
Post ending in (x),,,23,28,51,9,0.000047
Last Measure,,,97,37,134,41,0.000147
Sinistar,,,6,9,15,3,0.00003
Sage Freehaven,,,9,20,29,31,0.000016
Epic Threads,,,27,23,50,9,0.000046
4chan fgt hat day,,,10,11,21,9,0.000032
TITTY MONSTER,,,32,39,71,9,0.000092
4chon,,,6,5,11,9,0.000015
4chon.org,,,5,13,18,9,0.000017
News,,,31,7,38,14,0.000047
Anti-semitism,,,60,82,142,17,0.000089
White Nationalism,,,125,187,312,35,0.000121
Peter Chimaera,,,21,47,68,49,0.000024
Jkid,,,2,50,52,9,0.000012
HBGary Federal,,,13,124,137,26,0.000023
NekoArc,,,13,12,25,41,0.000024
Advertising,,,114,61,175,17,0.000211
4gifs,,,8,13,21,41,0.000024
The Netherlands,,,98,21,119,37,0.000214
Shock Image,,,39,43,82,6,0.000138
Shocked and Appalled,,,77,2,79,41,0.000096
SNC,,,4,83,87,0,0.000013
Ribaldry,,,4,39,43,39,0.000015
4girls,,,3,26,29,39,0.000012
Menstrual painting,,,31,23,54,39,0.000073
Pregnant,,,175,81,256,36,0.000259
4olderDump,,,2,10,12,10,0.000012
Bwatch,,,5,5,10,10,0.000018
Mi-Chan,,,5,6,11,10,0.000026
Chanmongler,,,6,11,17,10,0.00003
XChan Directory Dumper,,,11,20,31,10,0.000041
Python,,,21,31,52,10,0.000038
Haskell,,,4,32,36,10,0.000015
Superman,,,93,69,162,34,0.000175
Popular,,,61,6,67,21,0.00009
No more than 99,,,52,11,63,32,0.000088
4th of July,,,23,56,79,37,0.000035
Worldwide Masonic Conspiracy,,,238,89,327,17,0.00047
Holocaust denial,,,41,25,66,17,0.000074
Protocols of the Elders of Zion,,,42,38,80,17,0.000085
Hangover,,,17,23,40,35,0.000044
YouTube Independence Day,,,6,10,16,48,0.000013
George Washington,,,20,23,43,37,0.000078
Che Guevara,,,40,48,88,14,0.000071
Philadelphia,,,61,85,146,35,0.000076
Audreynoland,,,4,47,51,48,0.000012
500 Internal Server Error,,,2,1,3,10,0.000013
ED is slow,,,15,25,40,10,0.000045
50 Cents,,,14,49,63,35,0.000024
American Dream,,,7,49,56,35,0.00002
Capitalism,,,191,91,282,14,0.000411
Bullet to the Head of the NRA,,,48,43,91,58,0.000073
Ebonics,,,94,32,126,35,0.000176
Fursona,,,279,58,337,31,0.000239
Reliable sources,,,19,58,77,2,0.000021
Bike,,,108,43,151,35,0.000141
Perez Hilton,,,68,113,181,0,0.000152
U MAD,,,169,70,239,44,0.000183
Snakes on a Plane,,,52,54,106,22,0.000117
50 Million Names Project,,,1,9,10,32,0.000011
Bot,,,55,16,71,2,0.00007
Agile2013,,,4,11,15,19,0.000013
55chan,,,11,67,78,9,0.000017
Brchan,,,2,21,23,9,0.000011
LOL INTERNET,,,16,9,25,1,0.00004
Latin,,,52,89,141,37,0.000154
Orkut,,,11,28,39,21,0.000047
Brazilian Anonymous culture,,,2,8,10,9,0.000011
Verbose Thread,,,76,13,89,9,0.000266
"HAHAHA DISREGARD THAT, I SUCK COCKS",,,439,27,466,26,0.000651
DotA,,,26,102,128,49,0.000049
Brofist,,,11,10,21,9,0.000023
Cardcaptor Sakura,,,24,120,144,28,0.000042
Thread,,,48,46,94,9,0.000147
Xenu,,,101,31,132,26,0.000219
6-chan,,,6,19,25,9,0.000014
5P,,,1,8,9,8,0.000011
Beyond the Lampshade,,,2,23,25,8,0.000012
TV Tropes Drama,,,10,151,161,2,0.000027
5chan,,,6,15,21,9,0.000014
Iichan,,,7,32,39,9,0.000018
Wakachan,,,5,64,69,28,0.000016
60's Spider-Man,,,68,26,94,34,0.000091
60's Spider-Man/German,,,1,23,24,34,0.000014
Bill Hicks,,,24,51,75,9,0.000053
Sparkledogs,,,69,95,164,24,0.000111
Deadpool,,,25,31,56,34,0.000057
64chan,,,4,9,13,9,0.000011
99chan,,,12,30,42,9,0.000018
68.39.174.238,,,4,13,17,2,0.000015
Ignore All Rules,,,6,17,23,2,0.000013
Comcast disease,,,19,5,24,17,0.000045
Wikimedia Foundation,,,52,60,112,2,0.000072
6 BONG,,,5,6,11,42,0.000015
U WOT M8,,,39,72,111,42,0.000103
7-Eleven,,,33,22,55,35,0.000101
I Am In Your Base Killing Your D00ds,,,46,42,88,25,0.000098
Pig,,,145,55,200,35,0.000202
Slurpee,,,12,5,17,58,0.000048
Stereotypes,,,44,35,79,35,0.000047
7-Zip,,,2,17,19,10,0.000013
Category:Softwarez,,,34,0,34,10,0.00006
Hardcore,,,142,8,150,12,0.000215
Graphical User Interface,,,16,8,24,10,0.000067
FTP,,,4,3,7,10,0.000013
DEAL WITH IT,,,40,16,56,9,0.000055
707Fangirl,,,1,38,39,19,0.000011
PrincessElizabeth013,,,19,37,56,7,0.000018
E-go,,,131,53,184,7,0.000082
Senpai,,,8,12,20,7,0.000016
Disorder,,,82,71,153,13,0.000188
Reportfag,,,20,30,50,0,0.000036
TheRealAshleyKetchum,,,2,23,25,19,0.000013
Harassment,,,75,18,93,19,0.00007
Jewlion,,,9,34,43,31,0.000016
Plasma,,,4,35,39,9,0.000014
Pocky,,,44,17,61,28,0.000082
Lorf,,,7,19,26,31,0.000022
Apache,,,5,14,19,10,0.000014
NEDM,,,55,32,87,25,0.000099
Sean,,,2,24,26,9,0.000011
Bait,,,54,29,83,41,0.000056
Category:People,,,104,0,104,32,0.000156
Operation,,,19,43,62,26,0.000024
BME,,,43,68,111,63,0.000112
Stu makes chocolate pudding at 4 in the morning,,,25,16,41,34,0.00002
MySQL,,,10,21,31,10,0.000019
G00ns,,,17,6,23,9,0.000025
Wise Beard Man,,,66,70,136,26,0.000093
Magoo,,,23,107,130,26,0.00003
Howler,,,3,14,17,31,0.000027
H,,,2,1,3,54,0.000011
Encyclopedia Dramatica:Sandbox,,,15,0,15,49,0.000025
Operating system,,,25,28,53,10,0.00004
Shemale,,,246,75,321,63,0.000348
Email,,,92,51,143,64,0.000177
The Regime,,,10,25,35,26,0.000015
Wharrrgarbl,,,4,12,16,41,0.000011
"HA HA HA, OH WOW",,,316,17,333,7,0.000344
Bonzi Buddy,,,9,24,33,10,0.000014
Romanians,,,58,153,211,37,0.000118
Jewish Internet Defense Force,,,40,50,90,17,0.000066
Gurochan,,,16,11,27,22,0.00004
IMacros,,,8,1,9,26,0.000023
Code,,,20,18,38,10,0.000033
Botswana,,,6,24,30,35,0.000018
789chan,,,26,103,129,7,0.000029
Robert Wayne Stiles,,,39,253,292,7,0.000111
Anthony 'A-Log' LoGatto,,,104,330,434,7,0.000304
Jonathan Niehaus,,,10,55,65,31,0.000032
Caseydecker,,,7,55,62,7,0.000013
Sean Brackeen,,,7,24,31,7,0.000013
User:Cockguzzler123/Chantard,,,1,0,1,7,0.000011
Legi0n,,,30,93,123,7,0.000027
Tinychat,,,17,34,51,35,0.000029
Negi Springfield,,,9,16,25,52,0.000021
789chan/IntroMan,,,2,0,2,52,0.000011
Phobos,,,21,45,66,52,0.000026
Edgy,,,190,111,301,7,0.000134
Penis Pump,,,33,77,110,41,0.000079
Nick Bate,,,29,77,106,7,0.000086
Pop music,,,34,104,138,12,0.000058
Misogyny,,,80,54,134,36,0.000086
Steroids,,,99,6,105,49,0.000144
Duuuuuuuuuuuuuuuuuuuuhhh,,,178,25,203,23,0.000222
Schizophrenia,,,192,37,229,30,0.000247
Bear,,,112,68,180,40,0.000259
789chan/IRC Logs 2,,,1,0,1,7,0.000011
Encyclopedia Dramatica:IRC,,,10,0,10,10,0.000028
IHM,,,16,2,18,7,0.000031
Ahuviya Harel,,,33,164,197,7,0.000055
The Unknown Autobot,,,45,223,268,7,0.000129
789chan/IRC Logs,,,0,2,2,52,0.000011
78chan,,,8,115,123,9,0.000015
Doctor Who,,,132,127,259,33,0.000231
Lolicatgirls.swf,,,6,14,20,9,0.000018
Techno Viking,,,15,26,41,37,0.000028
Hot Topic,,,140,97,237,12,0.000215
Peter,,,14,24,38,9,0.000032
Cowboy,,,31,15,46,40,0.000044
Viking,,,67,66,133,37,0.000182
Beecock,,,20,6,26,9,0.000053
WWOEC,,,19,78,97,34,0.000083
FanFiction.Net,,,56,199,255,6,0.000082
Vorarephilia,,,240,69,309,31,0.000328
Catgirl,,,34,27,61,28,0.000046
PalComix,,,11,36,47,31,0.000023
Proxy,,,94,22,116,2,0.000133
Encyclopedia Dramatica:Donate,,,15,0,15,8,0.000053
Ian,,,6,8,14,9,0.000018
Grey Area,,,11,11,22,9,0.000022
Mockskin,,,2,16,18,10,0.000013
Odin,,,10,2,12,35,0.000024
Soviet Sunday,,,5,4,9,9,0.000016
Rules,,,34,28,62,9,0.000044
Gullible,,,93,10,103,36,0.000144
Sealand,,,9,41,50,37,0.000027
7track,,,3,20,23,9,0.000013
HelloISmileYou,,,5,10,15,9,0.00002
7jackass77,,,3,41,44,22,0.000011
Jeffrey Dahmer,,,44,56,100,22,0.000097
7ols,,,2,31,33,7,0.000044
Amphetamines,,,215,68,283,35,0.000246
Potato,,,23,10,33,7,0.000029
Dollar,,,9,2,11,17,0.000018
Acne,,,59,29,88,26,0.00011
Special Education,,,33,65,98,7,0.000097
7seveng7,,,2,27,29,48,0.000011
Idaho,,,20,32,52,35,0.00003
Defamation,,,93,32,125,8,0.000138
Inmendham,,,19,107,126,48,0.000045
Detective,,,142,24,166,8,0.000185
Piracy,,,56,16,72,10,0.000079
Harlequin Ichthyosis Fetus,,,54,29,83,46,0.000077
Ass Rape,,,52,12,64,39,0.000155
Wutchan,,,3,13,16,64,0.000042
Orgasm,,,180,6,186,39,0.000346
Brian Peppers,,,121,42,163,56,0.000219
Tony Sidaway,,,33,23,56,2,0.000078
DEFCON,,,18,33,51,10,0.000043
808chan,,,7,22,29,10,0.000017
Operation Payback,,,17,34,51,26,0.000036
Fallout,,,78,217,295,49,0.000097
Internet Humanitarianism,,,54,57,111,48,0.000068
Raidfag Wench,,,22,52,74,26,0.000058
Time Cube,,,129,50,179,46,0.000278
Daddy,,,170,81,251,36,0.000252
Cocktease,,,38,23,61,36,0.000098
K-line,,,31,25,56,41,0.000048
L. Ron Hubbard,,,96,114,210,26,0.000156
OSA,,,28,41,69,26,0.00003
David Miscarriage,,,41,51,92,26,0.000058
Joe Feshbach,,,2,6,8,26,0.000011
Ron Savelo,,,8,39,47,26,0.000015
Allah,,,107,72,179,37,0.000209
Fat Whore,,,52,22,74,52,0.000129
Google bomb,,,18,31,49,14,0.00003
ERepublik,,,10,115,125,0,0.000026
R3x,,,4,22,26,26,0.00002
Juggalo,,,160,195,355,51,0.000292
I See What You Did There,,,159,4,163,17,0.000324
Goodnight Sweet Prince,,,105,28,133,9,0.000158
Wizardchan,,,27,135,162,19,0.000049
Finland,,,86,102,188,37,0.000175
Jessica Elwood,,,12,63,75,38,0.000019
Baphomet,,,14,63,77,19,0.00002
Archive.is,,,10,14,24,19,0.00005
Fukken saved,,,29,10,39,9,0.000058
Edward Snowden,,,17,38,55,14,0.000032
Ben Garrison,,,34,26,60,19,0.000058
Brownpill,,,3,3,6,19,0.000028
Lord Foxworth,,,12,74,86,7,0.000031
Voat,,,11,119,130,19,0.000018
Eugenics,,,39,66,105,47,0.000075
Mighty Number 9,,,24,54,78,19,0.000029
Pixar,,,24,40,64,34,0.000039
GET OUT,,,57,9,66,33,0.000191
Colonel Quaritch does not give a fuck,,,11,62,73,33,0.00009
Tetris,,,19,42,61,49,0.000033
Why do you hate America?,,,115,43,158,14,0.000261
I Like to Watch,,,6,8,14,9,0.000021
Mall,,,22,52,74,12,0.000056
The Melancholy of Haruhi Suzumiya,,,40,119,159,28,0.000072
Jewcat,,,10,28,38,25,0.000031
Michael Phelps,,,27,66,93,9,0.000056
Sephiroth,,,57,81,138,29,0.000104
Flying Spaghetti Monster,,,33,30,63,46,0.000076
Sesame Street,,,24,5,29,34,0.000041
Man The Harpoons,,,217,26,243,52,0.000357
Jack Bauer,,,14,6,20,13,0.000032
InkLink,,,7,28,35,38,0.000038
Charles Bishop,,,7,25,32,58,0.000033
We're Not Afraid,,,1,22,23,37,0.000017
Ground Zero Mosque,,,14,50,64,37,0.000025
Rudy Ghouliani,,,21,24,45,37,0.000058
Cory Lidle,,,6,8,14,17,0.000038
Lolterrorism,,,4,14,18,41,0.000019
AMERICA FUCK YEAH!!,,,3,2,5,37,0.000024
Too soon,,,29,46,75,37,0.000048
ED does 9/11,,,1,1,2,37,0.000017
Arkady,,,7,29,36,2,0.000022
Squid Girl,,,19,129,148,28,0.000043
90 Day Jane,,,4,20,24,12,0.000025
Erik Rhodes,,,6,19,25,40,0.000055
Threatening suicide,,,11,19,30,13,0.000026
Almostanhero,,,5,2,7,9,0.000026
911bio-med,,,3,8,11,22,0.000011
916power,,,3,10,13,48,0.000011
Debate,,,54,24,78,8,0.000122
Cl0r0x,,,5,17,22,30,0.000014
Kelly Kalogerakos,,,14,144,158,36,0.000076
FunnyJunk,,,24,151,175,9,0.000054
Imgur,,,3,51,54,34,0.000014
Watermark,,,19,27,46,9,0.000043
Hai2u,,,35,17,52,6,0.000082
Good Guy Greg,,,15,31,46,9,0.000024
Fuck That Guy,,,15,27,42,9,0.000074
Me Gusta,,,8,25,33,9,0.000023
Friend Zone,,,87,61,148,36,0.000116
Advice Dog/Variations,,,19,15,34,9,0.000077
Cell Phone,,,51,40,91,8,0.000106
Mainstream,,,31,22,53,12,0.000073
IFunny,,,5,50,55,19,0.000024
I Can Has Cheezburger?,,,169,79,248,25,0.000422
HUGELOL,,,1,15,16,17,0.000013
Hayakain,,,9,64,73,31,0.000017
=3,,,0,2,2,61,0.000011
POMF =3,,,15,21,36,9,0.000033
Ray William Johnson,,,31,57,88,61,0.000071
Magick,,,70,48,118,27,0.00011
@CapsCop,,,5,6,11,64,0.000036
@horse ebooks,,,8,20,28,19,0.000021
Never forget,,,119,17,136,37,0.00031
Forever,,,32,3,35,37,0.000104
Implying implications,,,48,5,53,19,0.000049
Mr. Hands,,,181,39,220,31,0.000379
BMO,,,3,30,33,52,0.000014
Gurren Lagann,,,40,99,139,28,0.000042
Boku No Pico,,,29,49,78,28,0.000038
Why.jpg,,,43,8,51,7,0.000044
Mai Waifu,,,136,25,161,28,0.000149
Sagefag,,,7,29,36,9,0.000031
VLC Media Player,,,5,22,27,10,0.000015
My Life Me,,,3,25,28,28,0.000013
ACF,,,7,126,133,29,0.00002
Final Fantasy,,,139,24,163,49,0.000129
Online Dating,,,40,29,69,29,0.000054
Summoner Yuna,,,18,69,87,29,0.000033
Sephirothslave,,,22,90,112,29,0.000037
Internet police,,,112,48,160,41,0.000147
Allege,,,99,32,131,8,0.000134
A Plus,,,44,26,70,8,0.000127
Drama whore,,,147,21,168,8,0.000179
BFF,,,145,6,151,21,0.00013
No one likes you,,,68,84,152,13,0.000182
MASSIVE DAMAGE,,,39,51,90,49,0.000088
Noam Chomsky,,,33,57,90,14,0.000088
Anarchy,,,145,93,238,14,0.00018
The Swamp,,,41,98,139,14,0.000042
Genital Herpes,,,133,37,170,36,0.000306
Bureaucratic Fuck,,,208,148,356,2,0.00033
Fated Childrens Forums,,,2,138,140,29,0.000011
ACLU,,,14,28,42,14,0.000018
Mind control,,,28,23,51,46,0.000062
Same-sex marriage,,,22,52,74,19,0.000053
ACMA/Full List,,,5,1,6,26,0.000013
ACTA,,,7,53,60,10,0.000017
NO NIGGERS,,,85,49,134,35,0.000125
Zune,,,12,31,43,10,0.000044
Bribery,,,44,14,58,38,0.000048
RIAA,,,75,48,123,10,0.000099
EU,,,16,3,19,37,0.000027
Singapore,,,14,47,61,37,0.000016
Spain,,,166,136,302,37,0.000269
Dubai,,,28,66,94,37,0.000103
Internet Freedom Movement,,,4,11,15,10,0.000022
ROW ROW FIGHT THE POWAH,,,47,42,89,9,0.000081
FBCM,,,6,23,29,41,0.000013
Stichting BREIN,,,7,30,37,26,0.000015
Kid Rock,,,17,54,71,35,0.000061
The Great eBarrier Reef,,,25,53,78,26,0.000032
ADA,,,0,16,16,15,0.000011
C,,,42,39,81,10,0.000101
House of Jigsaw,,,4,110,114,32,0.000015
ADoseOfBuckley,,,6,48,54,7,0.000013
Peanuts,,,12,53,65,34,0.00002
Chris Brown,,,38,50,88,39,0.000042
I Hate Everything,,,11,105,116,7,0.000014
Attorney at lol,,,39,15,54,24,0.00006
The Harlan Show,,,4,39,43,7,0.00003
SpringBelleBunny,,,2,23,25,7,0.000011
AFAIK,,,1,5,6,49,0.000011
Acronym,,,38,51,89,57,0.000097
Wiki,,,146,99,245,2,0.000251
WoW,,,127,5,132,49,0.000131
I'm so confused,,,52,45,97,29,0.000118
AFP,,,4,7,11,53,0.000032
Beyblade,,,10,44,54,28,0.000021
Tim Sharky,,,139,17,156,36,0.000154
Dan Savage,,,15,35,50,40,0.000109
Epic Toilet Story,,,10,13,23,40,0.000659
Stay safe,,,9,4,13,19,0.000056
Miltopia,,,36,30,66,2,0.000096
Dani Faulk,,,11,41,52,40,0.000044
Andrew Sullivan,,,7,81,88,40,0.000045
Chris Morris,,,19,34,53,41,0.000063
Tom Serson,,,34,160,194,48,0.000056
Web AIDS,,,1,17,18,40,0.000034
STDCarriers,,,4,26,30,36,0.000049
Fiero425,,,9,124,133,44,0.000082
Discordianism,,,17,57,74,13,0.000069
Troll Shielding,,,49,50,99,7,0.000074
Flame,,,165,18,183,21,0.000203
Male Tears,,,18,15,33,19,0.000072
Deleting Your YouTube Videos,,,41,59,100,48,0.000042
Donald Drumpf,,,29,106,135,19,0.000055
Thomas Dimassimo,,,6,14,20,19,0.000021
AJcomix,,,8,48,56,0,0.000013
Skuee,,,20,112,132,48,0.000095
Giant dildo of death,,,61,16,77,31,0.000144
Encyclopedia Dramatica:Vandalism is Pointless,,,19,0,19,7,0.000025
H8r,,,65,22,87,12,0.000051
Gender,,,19,7,26,19,0.000051
Yahoo! Answers,,,64,73,137,38,0.000146
Gorilla warfare,,,27,17,44,9,0.000062
Nate Spidgewood,,,15,78,93,7,0.000045
ALYS,,,0,14,14,28,0.000011
Vocaloid,,,52,163,215,28,0.00006
UTAU,,,7,57,64,28,0.000014
AMD,,,14,16,30,10,0.000031
Intel,,,25,26,51,10,0.000043
FUD,,,3,17,20,10,0.000024
Brute Forcing,,,14,8,22,10,0.000033
Fermi,,,6,15,21,10,0.000019
AMG,,,2,8,10,12,0.000011
AMV,,,44,85,129,28,0.000064
Music video,,,1,0,1,28,0.000011
Sob story,,,59,29,88,19,0.000091
They Might be Giants,,,6,39,45,12,0.000013
Crossover,,,71,8,79,28,0.000081
Ad hominem,,,84,21,105,46,0.000214
Don't feed the trolls,,,57,28,85,41,0.000057
Windows Movie Maker,,,42,5,47,61,0.000051
Cascada,,,5,36,41,47,0.000014
Caramelldansen,,,26,39,65,28,0.000043
Avril Lavigne,,,33,47,80,2,0.000069
Kidz Bop,,,5,41,46,0,0.000014
Lady Gaga,,,128,154,282,36,0.000202
It was never relevant at all guise,,,1,0,1,28,0.000011
Gackt,,,16,37,53,28,0.000031
AMX Mod X,,,2,7,9,49,0.000011
Dev,,,1,0,1,49,0.000012
"ANOTHER ONE ADDED TO THE MUTE LIST, MMMHMMM",,,1,5,6,35,0.000011
Ohnotheydidnt,,,12,56,68,8,0.000033
ANSI Bomb,,,0,13,13,10,0.000011
DOS,,,34,27,61,10,0.00005
Batch,,,3,11,14,10,0.000014
Cult of the Dead Cow,,,16,35,51,10,0.000065
Gopher protocol,,,1,9,10,10,0.000011
AOHell,,,2,18,20,10,0.000018
Visual Basic,,,12,28,40,10,0.00002
Spyware,,,39,24,63,10,0.000052
Computer Gremlins,,,8,16,24,10,0.00002
MSN,,,67,81,148,3,0.000107
Smegma,,,45,10,55,17,0.000065
CD,,,9,19,28,12,0.000019
Willy on Wheels (on Wheels),,,52,20,72,2,0.000133
War on drugs,,,26,35,61,35,0.000092
PsyOps,,,23,20,43,41,0.000028
LJ TOS,,,52,10,62,8,0.000147
AimGirl.com,,,3,11,14,38,0.000016
Aol.pl,,,5,3,8,10,0.000027
Frienditto,,,25,30,55,8,0.00015
Chat log,,,19,22,41,1,0.00007
Screen name,,,29,43,72,59,0.000042
Sidekick,,,7,10,17,10,0.000021
Mozilla Firefox,,,87,105,192,10,0.000148
Teledildonics,,,5,31,36,39,0.000016
Yahoo!,,,105,66,171,13,0.000268
ICQ,,,20,23,43,10,0.000031
Blumpkin,,,11,5,16,39,0.000024
Alcoholic,,,169,33,202,36,0.000175
Aqua Teen Hunger Force,,,18,35,53,34,0.000037
Meebo.com,,,6,23,29,10,0.000021
SlashAIMslash,,,2,34,36,9,0.000025
Short type,,,3,26,29,38,0.000032
Esperanto,,,35,58,93,37,0.000125
APB: All Points Bulletin,,,1,27,28,49,0.000011
APHRP-DA,,,1,30,31,21,0.000011
Babypaste,,,18,14,32,6,0.000081
AQ Worlds,,,6,60,66,35,0.000016
Ku Klux Klan,,,270,90,360,35,0.000338
Crysis,,,25,65,90,49,0.000026
Ginger,,,218,92,310,42,0.00029
Tim Buckley,,,37,75,112,1,0.000039
File:800px-Realdiceshorty.png,,,3,0,3,59,0.000015
ARPAnet,,,1,24,25,26,0.000012
Vietnam War,,,33,47,80,37,0.000072
ZX Spectrum,,,5,29,34,10,0.000013
LUEshi,,,7,5,12,3,0.000039
LOL WUT/ASCII,,,4,0,4,41,0.000064
Hai2u/ASCII,,,5,0,5,39,0.000037
ASCIIdent,,,1,1,2,52,0.000014
Advice,,,11,2,13,9,0.000022
ASMR,,,6,35,41,13,0.000022
Elevator Filming,,,4,21,25,38,0.000019
Hypnosis,,,7,22,29,26,0.000014
Kaa VFX,,,4,18,22,31,0.000012
Xkcd,,,15,96,111,9,0.000045
Pane Series,,,3,7,10,10,0.000043
ATF,,,6,20,26,28,0.000031
AllTheFallen.ninja,,,7,17,24,28,0.000021
The beautiful people,,,30,65,95,2,0.000065
OBAMACORN,,,14,63,77,14,0.000033
Crips,,,23,39,62,35,0.000037
Waco,,,53,150,203,46,0.000091
Death Metal,,,16,58,74,12,0.000027
Massachusetts,,,51,142,193,35,0.000056
Bomb,,,49,11,60,37,0.000068
LED Ethernet Cables,,,3,7,10,10,0.000014
Darwin Awards,,,35,22,57,58,0.000079
Only 2 percent,,,33,19,52,9,0.000088
Atlanta,,,28,69,97,35,0.000074
Austin,,,18,140,158,35,0.000037
Portland,,,37,143,180,35,0.000062
Seattle,,,59,50,109,8,0.000117
Yuppie,,,72,103,175,35,0.000106
Lollercaust,,,146,21,167,48,0.000311
Scott Brown,,,5,0,5,14,0.000015
Connex Trains pwn3d,,,3,7,10,59,0.000012
Singularitarianism,,,5,27,32,10,0.000017
AWOLnow,,,3,11,14,19,0.000013
AXXo,,,3,44,47,10,0.000017
Admiral Ackbar,,,71,25,96,9,0.000113
Karl Marx,,,61,63,124,14,0.000088
Alt tab,,,6,9,15,18,0.000012
Dignity,,,17,38,55,8,0.00004
Quentin Tarantino,,,46,67,113,28,0.000093
Don't Copy That Floppy,,,16,35,51,10,0.000036
Seed Plz,,,4,19,23,10,0.000033
Leeching,,,41,41,82,8,0.000066
Seeding,,,3,3,6,10,0.000013
Deadfrog,,,4,10,14,10,0.000015
OiNK,,,16,74,90,10,0.000029
What.CD,,,12,22,34,10,0.000029
Waffles.fm,,,16,40,56,10,0.000031
P2P,,,35,55,90,10,0.000053
Tsukihime,,,3,21,24,28,0.000022
Cat in Microwave,,,8,16,24,25,0.000044
"It's a Kirby, Retard",,,9,21,30,41,0.000026
COMBO BREAKER,,,28,16,44,9,0.000039
X Everywhere,,,31,63,94,9,0.000104
Epin,,,17,14,31,9,0.000054
A Game of Pretend,,,12,10,22,40,0.000035
Shitpost,,,74,10,84,9,0.000101
Role-playing,,,265,52,317,31,0.000283
Mahou Sensei Negima,,,7,41,48,28,0.000013
He does it for free,,,34,6,40,19,0.000046
Ryulong,,,43,86,129,2,0.000064
Rude,,,9,26,35,24,0.000029
Constructive Criticism,,,54,23,77,21,0.000054
Shit Reddit Says,,,23,70,93,19,0.00008
Quicksand Fetish,,,2,47,49,20,0.000012
The Guardian,,,49,106,155,37,0.000087
Game Theory,,,14,52,66,49,0.000021
LOGIC AND REASON,,,19,43,62,46,0.00003
Nice Guys,,,146,64,210,36,0.000171
Skeleton,,,16,29,45,49,0.000048
Pictures plz,,,81,16,97,8,0.000125
Felicia Day,,,5,17,22,19,0.000013
Girl Gamer,,,42,50,92,19,0.000051
Circular logic,,,33,21,54,46,0.000116
Thunderf00t,,,47,64,111,46,0.00006
Foot Fetish,,,32,50,82,39,0.000038
Redundant,,,241,1,242,19,0.000522
Pseudo-intellectual,,,52,94,146,19,0.000078
Dragon Cave,,,9,156,165,16,0.000014
A Master Is Out,,,5,21,26,9,0.000037
Roll Call,,,9,0,9,9,0.000027
A Message From Chad and Steve,,,4,19,23,48,0.000012
Dgt2,,,17,4,21,8,0.000032
Chad Hurley,,,12,55,67,48,0.000021
Steve Chen,,,17,19,36,48,0.000028
Catchphrase,,,42,51,93,8,0.000159
Ppl,,,17,13,30,21,0.00003
Tardblog,,,2,4,6,6,0.000015
Blissyu2,,,25,84,109,2,0.000033
A Plus Newbie Award,,,2,25,27,57,0.000015
American Family Association,,,5,57,62,46,0.000014
Steal This Wiki,,,5,19,24,14,0.000013
Profane Existence,,,2,15,17,12,0.000011
Cleveland,,,24,201,225,35,0.000034
Memefag,,,36,165,201,9,0.000177
Oral Roberts,,,5,64,69,39,0.000022
Dave Chappelle,,,30,42,72,17,0.000049
Doutaini,,,9,53,62,31,0.000028
A RAPE SPIDER,,,19,20,39,31,0.000052
Camel Spider,,,20,30,50,25,0.000043
FTM,,,57,57,114,63,0.000098
A Real Guy,,,3,7,10,24,0.000011
Purple PJs,,,9,73,82,24,0.000018
A Scientologist's Guide to 4chan,,,6,52,58,9,0.000013
ITT,,,18,16,34,9,0.000039
FUCK YEAH SEAKING,,,107,60,167,9,0.000181
Rock Band,,,13,67,80,12,0.000023
A Serbian Film,,,3,17,20,22,0.000011
Pope,,,112,57,169,46,0.000286
Child abuse,,,128,37,165,13,0.000188
A Solid,,,1,25,26,37,0.000011
Heaven,,,62,74,136,46,0.000125
Marriage,,,128,71,199,36,0.000185
Language,,,33,41,74,37,0.000169
A Storehouse of Knowledge,,,5,28,33,46,0.000017
Creationist,,,112,86,198,46,0.000128
Just Google It,,,19,20,39,10,0.00003
RationalWiki,,,37,163,200,19,0.000121
A Womyn's Guide to Males,,,11,102,113,63,0.000037
Circumcision,,,114,112,226,17,0.000254
Erectile dysfunction,,,62,24,86,55,0.000153
Pedo Baiting,,,33,47,80,53,0.000149
Homophobia,,,138,83,221,40,0.000364
Domestic violence,,,107,42,149,39,0.000126
Manboobs,,,49,42,91,52,0.000076
Switch police on,,,15,33,48,9,0.000023
Sexism,,,28,17,45,39,0.000034
Marc Lepine,,,27,59,86,58,0.000054
MikeeUSA,,,6,45,51,39,0.00002
Tucker Max,,,6,25,31,32,0.000023
Unbirthing,,,37,19,56,31,0.000103
Jezebel,,,33,61,94,19,0.000097
A and an,,,3,13,16,58,0.00004
USB line,,,16,5,21,10,0.000041
Unicorn Orgy,,,19,10,29,31,0.000032
UFO,,,45,18,63,17,0.000059
Hello,,,9,6,15,9,0.000026
A bit sus,,,3,16,19,40,0.000016
Tacgnol,,,35,19,54,25,0.000077
Shiny Pidgey,,,14,22,36,9,0.000066
Wat do,,,12,31,43,9,0.000081
Internet troll personality disorder,,,20,35,55,41,0.000025
Narcissistic personality disorder,,,135,72,207,7,0.000174
Borderline personality disorder,,,44,90,134,12,0.000058
Carmen Electra complex,,,8,27,35,63,0.000021
Inconsistent personality disorder,,,18,13,31,24,0.000044
E-psychiatry,,,75,19,94,26,0.000141
Colton Harris Moore,,,2,13,15,11,0.000016
Condom Snorting,,,8,18,26,38,0.000042
Self-diagnosed,,,35,26,61,7,0.000049
Hozupindahows00s,,,9,52,61,7,0.000035
Internet Disease Chart,,,5,54,59,7,0.000018
Psychiatrists,,,45,23,68,26,0.000054
Pants nazi,,,10,14,24,37,0.000056
A hunter shoots a bear,,,3,11,14,31,0.000014
Create Your Own Story,,,10,16,26,2,0.000022
Hunting,,,11,33,44,31,0.000041
A poetry club,,,3,9,12,12,0.000014
Poetry,,,87,78,165,12,0.000214
Iambic pentameter,,,2,14,16,12,0.000012
Literature,,,21,26,47,12,0.000033
Ireland,,,203,148,351,37,0.000323
A thousand flaming penguins,,,2,4,6,61,0.000015
Fifty Hitler post,,,75,50,125,8,0.000214
Goggles,,,57,22,79,22,0.000138
Barrel Roll,,,93,53,146,9,0.000137
Potty Pete,,,13,46,59,12,0.00005
Otoya Yamaguchi,,,8,10,18,37,0.000026
Charlie Sheen,,,49,79,128,40,0.000051
You Win the Prize,,,76,4,80,58,0.000162
List of ways to win at the internet,,,15,30,45,8,0.000082
Fail to Win,,,11,51,62,9,0.000125
Aaron,,,0,14,14,26,0.000011
Aaron0883,,,1,28,29,26,0.000011
Aaron Burr,,,3,90,93,14,0.000012
AaronEverettLand,,,4,18,22,48,0.000013
Stickam,,,93,124,217,48,0.000127
Captain Bill Robertson,,,4,37,41,26,0.000013
Aaron Sorkin,,,2,24,26,24,0.000011
Evil-unveiled.com/Aaron Seyer,,,3,3,6,43,0.000011
Nietzsche,,,47,112,159,46,0.000102
Self-esteem,,,41,23,64,8,0.000084
Lolita,,,41,25,66,39,0.000053
Catholic,,,228,136,364,46,0.000467
E-Bully,,,12,18,30,41,0.000016
Buddha,,,80,91,171,46,0.000144
Jack Thompson,,,84,55,139,58,0.000179
Virginia,,,42,89,131,35,0.000041
Old School,,,28,17,45,12,0.000044
The Binghamton Tet Offensive,,,9,44,53,58,0.000043
Army,,,117,65,182,37,0.000168
Wild Faggot Appears,,,4,42,46,24,0.000011
Internet Law,,,210,127,337,41,0.000253
Gang,,,109,40,149,35,0.000155
Error,,,11,10,21,10,0.000016
Taint,,,13,5,18,39,0.000028
Cat fight,,,35,24,59,8,0.000091
Bernie Madoff,,,37,48,85,17,0.000134
Internet court,,,93,5,98,2,0.000187
Vanity Press,,,8,20,28,32,0.000016
Fuck My Life,,,16,65,81,1,0.000025
Womanizer,,,3,12,15,39,0.000011
Television Without Pity,,,4,17,21,3,0.000015
People Article,,,68,37,105,48,0.000074
Creative Commons,,,14,36,50,14,0.000025
Ellen Pao,,,10,82,92,19,0.000017
Pamperchu,,,21,46,67,7,0.00008
Chatroulette,,,20,41,61,18,0.000047
Opposites,,,3,63,66,37,0.000011
Stripper,,,94,38,132,36,0.000128
Clusterfuck,,,102,45,147,0,0.000099
Abandonware,,,2,17,19,49,0.000012
UNIX beard,,,10,8,18,10,0.000034
NES,,,46,31,77,49,0.000034
Internet poor,,,89,32,121,19,0.000099
John Romero,,,11,11,22,49,0.000017
Abbe Drake,,,2,8,10,17,0.000013
Abbey Road,,,10,37,47,12,0.000029
KISS,,,34,7,41,12,0.000096
The Beatles,,,62,36,98,12,0.000117
Abbreviation,,,5,7,12,57,0.000019
Abby Martin,,,3,12,15,2,0.000015
Russia Today,,,12,35,47,37,0.000028
Non-notable,,,92,18,110,2,0.000113
Abducted IRC,,,3,8,11,37,0.000012
Cyndre,,,22,58,80,48,0.000049
Furby,,,7,48,55,22,0.000025
Abigail,,,0,4,4,18,0.000011
Abigail and Brittany Hensel,,,4,27,31,18,0.000018
Abigaille,,,8,53,61,34,0.000058
Monster,,,17,7,24,18,0.000036
Pornolizer,,,3,4,7,18,0.00003
DevianTART Stamps,,,9,35,44,21,0.000013
Bunny,,,15,10,25,50,0.000027
Aspierations,,,77,89,166,7,0.000178
Avatar,,,62,11,73,33,0.000058
Mpreg,,,58,80,138,21,0.000056
Time paradox,,,69,25,94,32,0.000101
TS;DR,,,10,0,10,5,0.000086
Ableism,,,18,38,56,38,0.000032
Animal,,,113,73,186,25,0.000308
Derpy Hooves,,,18,33,51,7,0.000033
Ricky Gervais,,,18,77,95,26,0.000031
Finnish chans,,,12,47,59,9,0.00002
Soulbonding,,,11,58,69,8,0.000017
Social Justice Sally,,,8,9,17,39,0.000025
Chase 'No Face',,,16,15,31,25,0.000052
Trigger Warning,,,37,56,93,19,0.000058
Abner Louima,,,6,24,30,39,0.000029
IRL drama,,,19,31,50,8,0.00012
Lake Angel,,,9,14,23,56,0.000019
Sorry Day,,,4,21,25,35,0.000014
Honorary Ed Lolington,,,45,19,64,19,0.000066
"There, Their, and They're",,,22,20,42,3,0.000056
Strategy Guide,,,4,17,21,48,0.000015
Jack Kevorkian,,,17,23,40,13,0.000036
Falcon Punch,,,147,32,179,36,0.0003
Alternative Medicine,,,28,93,121,38,0.000068
Coat Hanger,,,1,4,5,46,0.000014
Clever,,,25,7,32,8,0.00005
Planned Parenthood,,,16,10,26,26,0.000036
The Army of God,,,5,47,52,46,0.000015
Chair,,,20,30,50,53,0.000087
Josef Mengele,,,14,15,29,37,0.000034
March Together For Life,,,2,22,24,2,0.00002
LJDrama,,,93,21,114,8,0.000316
Childfree,,,60,35,95,8,0.000116
Aliza Shvarts,,,20,44,64,41,0.000063
Juliana Wetmore,,,63,54,117,56,0.000107
Pennywise,,,13,46,59,34,0.000032
Renee Bracey Sherman,,,5,25,30,39,0.000034
Birth or Not,,,5,32,37,46,0.000018
Foetus soup,,,8,22,30,52,0.00002
Kevin and Kat,,,11,80,91,50,0.000033
Nathan Sheets,,,8,21,29,8,0.000022
Diaper Boy,,,6,51,57,42,0.000044
Above Top Secret,,,24,49,73,17,0.000032
Alien,,,152,37,189,17,0.000324
David Icke,,,42,61,103,17,0.000067
Coast to Coast AM,,,10,89,99,17,0.000024
JzG,,,25,13,38,2,0.000047
Uranus,,,8,7,15,46,0.000014
Zeitgeist,,,13,4,17,17,0.000024
Truther,,,24,33,57,17,0.000045
Truthism.com,,,21,55,76,46,0.00004
FOIA,,,8,2,10,17,0.000045
Abraham Lincoln,,,27,17,44,14,0.000108
Warren G. Harding,,,13,64,77,35,0.000026
Richard Nixon,,,58,80,138,14,0.000118
AbsenceOfTheAbsent,,,8,81,89,32,0.000012
FCTC,,,25,67,92,31,0.000023
Dylan Kimberlin,,,6,52,58,48,0.000013
SONYFANBOY,,,5,116,121,32,0.000031
Darksidered992,,,24,121,145,48,0.000021
YouTube Commentaries,,,40,188,228,61,0.000056
Spoiler,,,76,17,93,49,0.000057
Doxxing,,,35,4,39,32,0.000045
TL;DW,,,119,12,131,48,0.000145
YHBT,,,114,12,126,41,0.000127
KNIGHTRIDAH,,,6,75,81,32,0.000011
VloggerHeads,,,20,129,149,48,0.000032
Absinthe,,,1,21,22,41,0.000017
Chuck Testa,,,7,14,21,9,0.00002
Abstinence,,,10,69,79,36,0.000022
Technical virgin,,,39,29,68,12,0.000233
Asexuality,,,54,80,134,40,0.000143
Booty,,,16,5,21,29,0.000027
Husband,,,1,0,1,36,0.000011
WWJD,,,3,26,29,46,0.000011
Post-Traumatic Stress Disorder,,,47,23,70,19,0.000061
Purity Ball,,,7,16,23,39,0.000018
Bristol Palin,,,22,68,90,36,0.000049
Tween,,,42,35,77,36,0.000104
Abstruse,,,7,33,40,24,0.000013
SteveUberAlles,,,6,15,21,24,0.000012
Emily Jo,,,8,82,90,24,0.000023
Stupid Free,,,18,38,56,8,0.000041
Sand-filled vagina,,,9,20,29,24,0.000016
Ntokozo Qwabe,,,5,38,43,35,0.000016
Abunchofnumbers,,,1,1,2,8,0.000014
Abuse Filter,,,8,30,38,2,0.000014
MysteryBot,,,40,20,60,2,0.000097
JarlaxleArtemis,,,19,77,96,2,0.000023
Oversight,,,12,53,65,2,0.00002
ClueBot,,,6,68,74,2,0.000016
Acalamari,,,5,38,43,2,0.000014
New Hampshire,,,15,83,98,35,0.000026
Kelly Clarkson,,,9,13,22,36,0.000021
Barnstar,,,16,20,36,2,0.000023
Everyking,,,10,32,42,2,0.000016
Accidental Nudity,,,4,15,19,39,0.000047
Hunter Moore,,,8,30,38,59,0.000028
Ace Combat,,,3,44,47,49,0.000011
Ubisoft,,,12,57,69,49,0.000019
Asia,,,136,113,249,37,0.000287
North Atlantic Treaty Organization,,,17,57,74,37,0.000034
OUYA,,,1,14,15,49,0.000011
World of Tanks,,,9,74,83,49,0.000037
Hallcats Squadron,,,2,50,52,21,0.000011
Antony Aguilar,,,4,56,60,7,0.000012
Ace The Dragon,,,1,3,4,10,0.000011
Ace of Spades,,,4,102,106,0,0.000014
Jagex,,,12,15,27,49,0.000021
Rule 63,,,70,21,91,34,0.000067
Camping,,,22,41,63,49,0.000139
Special:ListAdmins,,,5,0,5,0,0.000044
Griefing,,,29,110,139,49,0.000031
Swastika,,,29,13,42,37,0.000065
Lag,,,19,20,39,49,0.000022
Suck,,,87,2,89,32,0.000157
I has a shuvel,,,21,5,26,9,0.000054
FPS,,,68,32,100,49,0.000064
Acfan,,,3,15,18,8,0.000016
Animal Crossing,,,23,83,106,49,0.000037
Prank,,,28,13,41,41,0.000033
Quitting IRC Forever,,,87,9,96,41,0.000096
Achaea,,,5,21,26,31,0.000023
New Age,,,37,58,95,46,0.000052
Why wont my parakeet eat my diarrhea,,,4,9,13,10,0.000044
"Fuck you, I'm a dragon!",,,225,43,268,31,0.000262
Acidentphlosoph,,,1,5,6,46,0.000011
Acidexia,,,1,12,13,8,0.000011
Cult,,,236,89,325,26,0.000356
Oh,,,7,7,14,39,0.000028
Monkey Island,,,10,37,47,33,0.000023
Boyfriend,,,110,13,123,36,0.000098
Acommissionreviewer,,,4,3,7,46,0.000011
FCU777,,,2,31,33,46,0.000014
Btw,,,24,7,31,8,0.000053
Ftw,,,80,29,109,14,0.000342
FYI,,,3,2,5,19,0.000014
IMHO,,,3,17,20,8,0.000013
IIRC,,,3,12,15,41,0.000013
OIC,,,2,5,7,57,0.000013
ROFLCOPTER,,,47,33,80,48,0.000185
DRM,,,21,54,75,10,0.000032
NAACP,,,10,7,17,35,0.000019
RML,,,1,4,5,8,0.000012
FOAD,,,5,17,22,0,0.000016
Fursecution,,,183,118,301,31,0.000281
TLA,,,4,11,15,57,0.000071
Acrotomophilia,,,14,45,59,39,0.000065
Plushie,,,116,50,166,31,0.000125
X? In My Y?,,,111,46,157,9,0.000237
Amputee,,,13,0,13,39,0.000043
Actor,,,55,51,106,36,0.000127
Boob shots,,,9,2,11,8,0.000019
Yokeup,,,20,55,75,46,0.000038
Belladonna,,,10,26,36,36,0.00002
Cdaae,,,10,7,17,8,0.000023
Hugh Jackman Can Ride Anything,,,4,19,23,9,0.00002
Sasha Grey,,,11,18,29,39,0.000021
AdBlock,,,19,25,44,19,0.00004
Google Chrome,,,28,42,70,10,0.000056
YouPorn,,,18,33,51,54,0.000052
Internet Explorer,,,53,41,94,10,0.000096
Opera,,,11,3,14,10,0.000027
DarksydePhil,,,37,87,124,7,0.000076
Linkara,,,24,133,157,61,0.000043
AdFly,,,3,9,12,17,0.000012
Gish Gallop,,,4,26,30,46,0.000059
How About A Nice Big Cup Of Shut The Fuck Up,,,8,3,11,9,0.000055
BCE,,,1,19,20,46,0.000019
Meh,,,51,18,69,3,0.000142
Die Antwoord,,,15,114,129,35,0.000029
Rocky Dennis,,,3,27,30,56,0.000015
Adam,,,2,20,22,35,0.000011
Adam's Block,,,4,22,26,35,0.000013
Adam L. Goldstein,,,7,23,30,41,0.000013
Adam Pacitti,,,2,2,4,29,0.000013
Adam Sessler,,,7,39,46,19,0.000015
X-Play,,,10,29,39,19,0.000025
Adam Sharp,,,7,15,22,14,0.000013
Missouri,,,27,71,98,35,0.000104
Adam Wan,,,12,64,76,31,0.000019
Adam Laird Katswell,,,3,19,22,7,0.000012
Adam Goodes,,,1,7,8,35,0.000011
Homeless,,,151,30,181,35,0.000167
Are You Fucking Kidding Me,,,14,44,58,9,0.000023
Contra,,,11,234,245,17,0.000016
WASP,,,20,8,28,35,0.000046
DOUBLE NIGGER,,,126,58,184,35,0.000186
Lowtax,,,50,53,103,26,0.000099
Mechanophilia,,,44,38,82,28,0.000052
OmniverseGirl,,,3,29,32,7,0.000014
Big Rigs: Over the Road Racing,,,9,35,44,49,0.000053
Crazy Bus,,,7,23,30,34,0.000014
The Magic School Bus,,,6,39,45,17,0.000013
Battlestation,,,7,23,30,38,0.000019
Mein Kampf,,,31,35,66,17,0.000051
Baby P,,,10,45,55,32,0.000024
Armin Meiwes,,,17,29,46,22,0.000059
Heaven's Gate,,,21,30,51,46,0.000045
MSPaint Adventures,,,42,124,166,15,0.000047
Vampire,,,192,166,358,27,0.000314
Dead or Alive,,,16,100,116,28,0.000022
Adam Lanza/Dream,,,1,0,1,58,0.000012
Adam Lanza/SBB,,,1,1,2,58,0.000012
George Sodini,,,17,65,82,58,0.000036
Luby's massacre,,,6,16,22,58,0.00002
Kip Kinkel,,,3,36,39,58,0.000014
Valve,,,48,37,85,49,0.000044
Tim Kretschmer,,,24,79,103,58,0.000052
Combat Arms,,,2,67,69,24,0.000012
Nihilism,,,22,81,103,46,0.000051
Resident Evil,,,45,5,50,49,0.000056
Sandy Hook Promise,,,2,20,22,58,0.000013
Christmas,,,129,91,220,46,0.000255
Deceased Wikipedians,,,16,89,105,2,0.000032
Charles Whitman's Tumor,,,23,54,77,58,0.000029
Hanukkah,,,11,45,56,46,0.000025
I Dunno LOL,,,39,9,48,32,0.000046
Jumped the shark,,,37,43,80,34,0.000049
Pic Unrelated,,,22,15,37,9,0.000116
Google Drop,,,5,20,25,10,0.000044
Original research,,,39,30,69,2,0.000091
Glossary of Scientology,,,6,49,55,26,0.000015
Shark,,,14,5,19,34,0.000035
G4,,,21,52,73,32,0.000031
Egoraptor,,,15,34,49,19,0.000025
Pepsi,,,4,6,10,13,0.000012
Cock goes where?,,,25,9,34,39,0.000088
Skype Con Leak,,,7,18,25,19,0.000014
Overwatch,,,16,66,82,19,0.000033
Crash Override Network,,,7,19,26,19,0.000015
Awwright,,,96,8,104,31,0.000162
Overrated,,,28,52,80,12,0.000031
Drama Llama,,,53,50,103,21,0.000064
Special:Allpages,,,37,0,37,49,0.000048
Add to cart,,,5,4,9,8,0.000018
One click,,,3,7,10,8,0.000027
Addict,,,77,42,119,23,0.000096
Comment whore,,,40,16,56,8,0.000104
Cash,,,41,6,47,2,0.000076
Alcoholics Anonymous,,,16,52,68,23,0.000043
Bible Thumper,,,17,20,37,46,0.000022
Addison Mikkelson,,,5,97,102,17,0.000024
Fuck The Police,,,40,68,108,35,0.000104
Kansas City,,,35,52,87,35,0.000079
Police Brutality,,,48,42,90,35,0.000096
Jack Vale,,,1,5,6,7,0.000011
Paranoid,,,114,23,137,30,0.000097
There are no niggers on the Internet,,,24,80,104,35,0.000077
E-penis,,,243,36,279,16,0.000242
Biggie Smalls,,,11,3,14,35,0.000026
Rex Beowulf,,,6,20,26,31,0.000062
Foodfight!,,,18,50,68,34,0.000019
Lunchtimers.com,,,5,14,19,9,0.00002
Addy,,,1,28,29,1,0.000015
Slenderman,,,30,22,52,9,0.000032
Jeff the Killer,,,10,26,36,38,0.000016
Adele,,,10,36,46,52,0.000041
Tory,,,29,30,59,37,0.000061
Cheeseburger,,,17,2,19,25,0.000038
Obamacare,,,26,94,120,14,0.000035
Susan Boyle,,,17,46,63,37,0.000044
Adella,,,9,54,63,8,0.000016
Dramouted,,,13,27,40,8,0.000028
Aimee Louise Sword,,,12,35,47,28,0.000042
Glomp,,,9,14,23,21,0.000022
Come at me bro,,,8,21,29,57,0.000014
Asspat,,,30,8,38,31,0.000025
Pizza and Beer,,,72,34,106,52,0.000125
Adequacy.org,,,5,31,36,10,0.000012
Kuro5hin,,,12,27,39,10,0.000042
Alt.religion.scientology,,,19,38,57,26,0.000025
DSFARGEG,,,22,1,23,9,0.00004
Gravitation,,,9,51,60,28,0.000017
Apartheid,,,35,94,129,35,0.000087
Chris-chan/Megan Saga,,,11,66,77,56,0.000039
IM PRESSIN CHARGES,,,86,26,112,35,0.000098
Ex-Gay,,,21,36,57,40,0.000035
Proposition 8,,,31,84,115,14,0.000131
Trolling Induced Transsexuality Syndrome,,,25,43,68,7,0.000066
Bahar Mustafa,,,15,121,136,19,0.00002
Administrators' noticeboard,,,12,34,46,2,0.000019
Wikipedia Admin Gallery,,,61,69,130,2,0.000118
Tautology,,,9,3,12,35,0.000018
Assume good faith,,,13,35,48,2,0.000019
BLP,,,17,86,103,2,0.00002
MediaWiki,,,26,5,31,2,0.000026
Adnan Oktar,,,4,41,45,46,0.000013
Harem Comedy,,,34,27,61,28,0.000075
Bill Gates,,,118,98,216,10,0.000189
Satanist,,,118,252,370,46,0.000201
Intelligent design,,,16,34,50,46,0.000035
Adobe,,,18,22,40,10,0.00003
N00dz,,,65,11,76,8,0.000077
Fark,,,34,86,120,34,0.000071
Worth 1000,,,4,64,68,5,0.000023
Irfanview,,,2,11,13,8,0.000024
Dragon Ball AF,,,6,23,29,21,0.000029
Lotus Breast,,,16,22,38,6,0.000065
Downfall,,,9,35,44,22,0.000022
Zyklon B,,,20,23,43,37,0.000056
Rainbow Stalin,,,92,8,100,37,0.000142
Denmark,,,64,35,99,37,0.000162
Austria,,,58,106,164,37,0.0001
Lynching,,,64,42,106,35,0.000075
Bipolar Disorder,,,139,83,222,13,0.000149
Skinhead,,,60,56,116,40,0.000119
Less than three,,,53,28,81,32,0.000137
Baseball,,,52,55,107,35,0.000099
Football,,,74,12,86,35,0.000135
Soccer,,,75,127,202,37,0.000155
Vespene gas,,,22,13,35,21,0.00004
Uwe Boll,,,41,73,114,19,0.00009
Nightclub,,,11,56,67,12,0.000026
Doge,,,46,44,90,9,0.000064
Kitler,,,13,10,23,25,0.000056
Maury,,,51,47,98,36,0.000103
Six Degrees of Adolf Hitler,,,8,34,42,37,0.000027
Colonel Klink,,,3,33,36,40,0.000032
DeviantART Nazis,,,16,73,89,21,0.00004
Hipster Hitler,,,7,17,24,12,0.000025
Holocaust Porn,,,21,18,39,17,0.000105
Mecha-Hitler,,,16,27,43,46,0.00007
Ruining The Internet,,,51,172,223,31,0.000097
Tranquility Bay,,,4,12,16,11,0.000024
The Jewish Question,,,9,30,39,37,0.000055
Bodies Under Siege,,,6,52,58,12,0.000028
The Royal Family,,,64,290,354,27,0.000118
Adorkablegrrl,,,5,28,33,5,0.000011
Kathy Sierra,,,8,34,42,5,0.000019
Violet Blue,,,11,74,85,42,0.000024
Halp,,,17,8,25,41,0.000038
Fair use,,,22,12,34,61,0.000027
OKCupid,,,20,42,62,8,0.000047
AdrenalineOn,,,4,51,55,59,0.000017
Physics,,,26,32,58,3,0.00004
ForeverKailyn,,,6,113,119,35,0.000013
John Sakars,,,4,27,31,31,0.000014
Adria Richards,,,17,44,61,39,0.000041
GG,,,104,18,122,50,0.000084
Rape culture,,,36,37,73,39,0.000072
Brogrammer,,,5,20,25,19,0.000013
University of Phoenix,,,17,60,77,14,0.000025
Blood on the Dance Floor,,,41,132,173,12,0.000044
BRILLIANT!,,,16,0,16,34,0.000027
Nothing Toxic,,,6,73,79,1,0.000014
Operation /b/ipolar,,,5,43,48,9,0.000024
Adrian Lamo,,,5,7,12,41,0.000016
Hobosexual,,,15,16,31,41,0.000035
The Tale of the traveling Afghan War Diaries,,,4,57,61,41,0.000015
"The Elder Scrolls IV: Oblivion/Stop right there, criminal scum!",,,24,22,46,9,0.000048
Adrian Pomorski,,,0,10,10,25,0.000011
Pumba Jeffery Larocque,,,6,10,16,39,0.000017
Adrianne Curry,,,3,4,7,12,0.000014
Tomgreen,,,12,74,86,41,0.000015
Inuyasha,,,58,134,192,28,0.00007
Bump,,,35,24,59,9,0.000052
Plastic crap,,,163,42,205,7,0.000238
Gabe Newell,,,48,43,91,49,0.00012
Team Fortress 2,,,189,169,358,49,0.000422
Paul Reubens,,,11,48,59,35,0.000048
Old Gregg,,,8,13,21,21,0.000028
Moral Orel,,,1,30,31,38,0.000012
Pickles,,,22,60,82,9,0.000064
Metal,,,83,8,91,12,0.00011
OH GOD BILL,,,10,5,15,39,0.000016
Satire,,,53,1,54,48,0.000061
Squidbillies,,,3,10,13,9,0.000012
The Boondocks,,,25,79,104,35,0.000036
Brittany Murphy,,,5,23,28,40,0.000018
Dave Hopkins,,,15,75,90,39,0.000022
Where The Dead Go To Die,,,4,42,46,34,0.000013
Happy Tree Friends,,,26,115,141,62,0.00003
Zach Braff Quotes,,,20,44,64,9,0.000035
Full House,,,11,28,39,34,0.000035
Comedy Central,,,42,47,89,34,0.000087
Mc chris,,,9,52,61,12,0.000033
Unikitty,,,18,71,89,34,0.000122
Adura,,,1,29,30,34,0.000011
Canadia,,,106,2,108,37,0.000173
Happy Wheels,,,2,62,64,0,0.000011
Good Korea,,,55,29,84,37,0.000105
Advance Wars,,,6,126,132,49,0.000019
Fire Emblem,,,11,85,96,15,0.000025
Cuntpaste,,,53,5,58,49,0.000198
Fire,,,75,63,138,29,0.000143
Period,,,141,47,188,39,0.000186
I just wanted to make it snow,,,5,26,31,48,0.000024
Closet Furry,,,76,53,129,31,0.000076
Call of Duty 4: Modern Warfare,,,32,122,154,57,0.000055
Zeriara,,,66,69,135,21,0.000107
"That's not funny, my brother died that way",,,12,25,37,9,0.00004
Laura Talbot,,,4,43,47,24,0.000022
Concerned Mother,,,117,134,251,58,0.000155
Defense,,,9,15,24,49,0.000023
Tourneyfag,,,78,109,187,49,0.000079
Tinychan,,,20,71,91,9,0.000038
Advanced Placement,,,1,61,62,11,0.000012
Student,,,33,65,98,14,0.000048
Parents,,,76,23,99,54,0.000123
Teacher,,,21,21,42,13,0.00002
Air,,,3,12,15,28,0.000017
Cheeyev,,,17,47,64,21,0.000042
Mother,,,59,6,65,39,0.000082
Test,,,1,1,2,11,0.000011
SAT,,,10,53,63,11,0.000028
Adventure Time,,,57,127,184,34,0.000086
Ear Rape,,,68,58,126,12,0.000082
Hotel Mario,,,20,41,61,20,0.000043
Adventure Time/Episode Guide,,,1,38,39,34,0.000011
Power Rangers,,,51,98,149,28,0.000083
Trippin,,,4,12,16,53,0.000015
Oral,,,45,10,55,19,0.000115
Cliché,,,39,21,60,49,0.000034
LoveShy,,,61,63,124,7,0.000141
Regular Show,,,20,50,70,34,0.000026
Star vs. the Forces of Evil,,,22,105,127,34,0.000039
I masterbauted right after the Sandy Hook Shooting,,,10,33,43,58,0.000025
Self-insert,,,76,34,110,21,0.000046
Pawfur,,,21,14,35,31,0.00004
Calvin and Hobbes,,,30,46,76,38,0.000064
Werewolves,,,21,42,63,31,0.000026
Psychic,,,46,28,74,27,0.000086
Article,,,124,7,131,2,0.000254
North American Union,,,19,64,83,14,0.000035
Server,,,12,6,18,10,0.000023
Infotainment,,,3,5,8,8,0.000014
Hawaii,,,33,13,46,35,0.000052
Small,,,28,9,37,63,0.000044
HeadOn,,,6,24,30,6,0.000019
Porn Advertisements,,,5,51,56,13,0.000018
Forced Memes (Television),,,8,33,41,9,0.000033
Advice Aeralik,,,3,9,12,49,0.00002
Sony Online Entertainment,,,19,15,34,49,0.00003
Advice Bitch,,,1,8,9,9,0.000011
Advice Boy,,,2,1,3,49,0.000011
Advice Chihuahua,,,1,5,6,9,0.000011
FanArt Central,,,18,113,131,28,0.000029
Advice Chink,,,2,9,11,9,0.000014
Advice Colin Mochrie,,,2,4,6,1,0.000016
Advice Cripples,,,1,2,3,17,0.000011
Advice Dawg,,,1,1,2,9,0.000011
Hatman,,,4,38,42,38,0.000019
Allan,,,19,87,106,31,0.000025
Gordon the Pringles Giraffe,,,33,74,107,9,0.000132
Asinine American,,,13,6,19,52,0.000036
Business Cat,,,4,20,24,61,0.000025
Colorbar,,,28,28,56,8,0.000048
Scumbag Steve,,,27,51,78,9,0.000037
PROJECT CHANOLOGY/SPY VS SCI : LICENSE TO LULZ,,,5,7,12,26,0.000026
Advice Faggot,,,1,2,3,1,0.000011
Advice Fawkes,,,1,3,4,9,0.000011
Advice Geezer,,,2,11,13,9,0.000021
They see me rollin',,,10,22,32,9,0.000032
Joseph Ducreux,,,4,12,16,9,0.000015
PurpleDrank,,,5,7,12,0,0.000013
Advice Japan,,,1,7,8,9,0.000011
Advice Kamina,,,1,5,6,28,0.000011
Advice Psycho,,,2,2,4,9,0.000011
Advice Quran,,,2,2,4,37,0.000012
Denial Bible,,,3,13,16,46,0.000016
Advice Retard,,,1,8,9,9,0.000011
Lamp,,,6,17,23,9,0.00003
Advice Rick,,,3,7,10,9,0.000012
Advice Rorschach,,,3,3,6,9,0.000012
Advice Rybak,,,1,6,7,9,0.000011
Alexander Rybak,,,11,26,37,9,0.000028
Advice Steve Jobs,,,2,12,14,10,0.000012
MacRumors,,,7,28,35,10,0.000021
Advice Troll,,,1,1,2,9,0.000011
Advocacy,,,2,19,21,10,0.000015
Mailing list,,,11,17,28,41,0.000022
Wikipe-tan,,,20,70,90,2,0.000061
EDF1,,,4,119,123,52,0.000013
I'm so random,,,38,66,104,12,0.000103
Cracked,,,31,132,163,19,0.00004
Metapedia.org,,,31,93,124,2,0.000062
Akinator,,,10,31,41,13,0.000024
Samwell,,,22,22,44,40,0.000029
OS-tan,,,16,43,59,10,0.000034
Firefox-ko,,,6,19,25,10,0.000014
Emma Sulkowicz,,,39,71,110,39,0.00004
Aegion,,,4,19,23,8,0.00002
Howard Dean,,,14,32,46,14,0.000025
Six Apart,,,17,12,29,8,0.000061
LiveJournal Caste System,,,5,39,44,8,0.000017
Nickolaus,,,13,32,45,8,0.000041
Aelius,,,4,8,12,8,0.000012
Aempirei,,,4,14,18,41,0.000014
Gypsies,,,82,42,124,37,0.000163
Hepkitten,,,68,18,86,41,0.000258
Guruubii,,,7,23,30,21,0.000024
Paheal,,,29,167,196,28,0.000059
Aertheca,,,1,65,66,63,0.000011
Intelligence,,,77,143,220,11,0.000093
Middle East,,,74,21,95,37,0.000119
IPN,,,53,3,56,49,0.000084
Babyfur,,,166,66,232,31,0.000209
Kelly Martin,,,39,66,105,2,0.000054
Kewian,,,17,21,38,39,0.000059
Main Page,,,35,1,36,8,0.00011
Aeverine Nieves/Interview,,,1,0,1,48,0.000011
American Idol,,,67,64,131,29,0.000101
Tosh.0,,,26,68,94,34,0.000079
So-called,,,9,10,19,8,0.000042
AfD,,,31,25,56,2,0.000048
Wikipedia Policies and Guidelines,,,27,30,57,2,0.000043
Fight Club,,,44,42,86,9,0.000077
Wikistalking,,,16,15,31,2,0.000035
Geoshities,,,57,41,98,10,0.000081
Chrono Trigger,,,14,62,76,29,0.000027
Netscott,,,6,4,10,2,0.000016
Neutral point of view,,,51,16,67,2,0.000165
Dutchland,,,25,8,33,60,0.000097
Kyrgyzstan,,,8,46,54,37,0.00002
Afr0blu3,,,4,19,23,61,0.000011
Asalieri,,,36,145,181,61,0.000058
Planet of the Apes,,,7,37,44,35,0.000036
"Сибирской говор",,,37,25,62,2,0.000042
Stone Age,,,1,2,3,46,0.000016
Clitoris,,,35,39,74,39,0.000122
Literally,,,122,28,150,19,0.000197
Kentucky,,,34,18,52,35,0.000048
Pat Robertson,,,27,61,88,46,0.000058
Elvis Presley,,,72,78,150,35,0.000139
South Africa,,,52,102,154,35,0.000112
You Gonna Get Raped,,,27,16,43,35,0.000063
Arbitration Committee,,,57,91,148,2,0.000076
Recent changes patrol,,,30,53,83,2,0.000033
Voodoo,,,31,31,62,35,0.000064
Non sequitur,,,12,5,17,56,0.000039
Afrocentrism,,,12,171,183,35,0.000122
Black History Month,,,20,36,56,35,0.00005
HowToBasic,,,15,40,55,39,0.00002
Kenya,,,19,18,37,35,0.000052
Tanzania,,,7,37,44,35,0.00002
African vulture,,,1,20,21,34,0.000011
Caillou,,,6,30,36,34,0.000023
Trigger,,,123,32,155,19,0.000131
Enterbots/nav,,,1,0,1,34,0.000011
Swearing,,,54,68,122,34,0.000128
Closing Logos Wiki,,,2,11,13,34,0.000012
Afro-chan,,,3,17,20,9,0.000013
Nigga Know Technology,,,18,7,25,35,0.000042
Afro Ninja,,,11,47,58,34,0.000017
Etc,,,29,20,49,37,0.000061
Internet money,,,37,16,53,8,0.00006
Malcolm X,,,24,49,73,35,0.000064
Black Supremacy,,,20,41,61,35,0.00004
Sargon of Akkad,,,47,85,132,19,0.000059
WE WUZ KINGZ AN SHEIT,,,23,29,52,35,0.00005
BLACK FACE contempo,,,3,27,30,35,0.000013
National Alliance,,,10,66,76,35,0.000016
White supremacy,,,11,32,43,35,0.000023
Comic book fans,,,38,55,93,34,0.000062
Egypt,,,70,64,134,37,0.000111
Carlos Latuff,,,26,70,96,37,0.000039
Pat Condell,,,8,14,22,46,0.000016
RedLetterMedia,,,13,11,24,61,0.000021
Moon Man,,,39,52,91,19,0.000048
Kill la Kill,,,25,76,101,28,0.000027
Moviebob,,,26,103,129,19,0.000034
Resident Evil 5,,,19,75,94,49,0.00005
Zimbabwe,,,35,77,112,35,0.000095
Indigoxix,,,4,4,8,19,0.00002
Mister Metokur,,,25,39,64,19,0.000024
Chadwardenn,,,22,34,56,49,0.000034
Whitewashing,,,4,11,15,35,0.000014
Afroduck,,,15,5,20,9,0.000036
Habbo Revisited,,,5,6,11,9,0.00003
Afterburner,,,2,10,12,34,0.000012
Allspark,,,7,23,30,34,0.00002
Race,,,23,21,44,35,0.000049
Agar.io,,,3,70,73,37,0.000014
Ragequit,,,200,28,228,19,0.00012
Québec,,,22,49,71,37,0.00004
Portugal,,,52,87,139,37,0.000089
Taiwan,,,18,120,138,35,0.000044
Estonia,,,13,28,41,37,0.00005
Vinesauce,,,3,45,48,61,0.000011
Snake,,,5,4,9,22,0.000021
Portal:Softwarez,,,3,4,7,10,0.000014
Pac-Man,,,26,52,78,49,0.000033
Petridish.pw,,,1,11,12,37,0.000011
Anarchy Online,,,6,93,99,49,0.000014
Star Trek Online,,,5,7,12,49,0.000019
ConceptArt,,,18,45,63,21,0.000032
V,,,5,46,51,9,0.000015
Transformation,,,25,81,106,31,0.000029
Age of consent,,,12,55,67,39,0.000064
Socrates,,,24,100,124,46,0.000063
Thailand,,,53,51,104,39,0.000148
Amazon,,,87,43,130,53,0.000146
Kobe Bryant,,,11,28,39,39,0.000042
Ron Jeremy,,,27,37,64,18,0.000037
Dianetics,,,23,65,88,26,0.000032
Phoenix Wright,,,54,171,225,40,0.000093
Cry moar,,,47,20,67,24,0.000096
Tom Newton,,,16,83,99,26,0.000021
Andy Kaufman,,,25,30,55,41,0.000045
Agent Smith,,,13,26,39,9,0.00002
PixelBeeProductions,,,36,64,100,48,0.00007
Neo,,,7,8,15,9,0.00002
Ryle Garamonde,,,10,39,49,53,0.000019
Agentmike,,,4,8,12,7,0.000056
Bitzi,,,2,30,32,3,0.000017
Hashtag,,,34,12,46,19,0.00003
Breatharian,,,11,48,59,46,0.000033
Taco Bell,,,43,47,90,35,0.000095
Agnph,,,20,29,49,31,0.000025
UrbanDictionary.com,,,66,55,121,3,0.000235
Agoddessfinch,,,1,57,58,21,0.000011
Agony In Pink,,,1,14,15,22,0.000011
Raping Little Suzy,,,19,26,45,22,0.00007
Bart Gets The Burdizzo,,,2,9,11,22,0.000014
Agoraphobia,,,5,23,28,13,0.000018
Fibromyalgia,,,23,69,92,13,0.000063
Anthropophobia,,,15,26,41,31,0.000056
Agoraphobic-Blue,,,6,27,33,31,0.000013
Warriors,,,9,108,117,36,0.000014
HinaUchi,,,11,39,50,19,0.000031
"Ah fuck, I can't believe you've done this",,,30,21,51,9,0.000039
Ahastar,,,1,1,2,37,0.000024
Diablo The Rex,,,1,2,3,37,0.000031
Dallas,,,11,3,14,35,0.00003
Burn a Koran Day,,,19,95,114,37,0.000033
Hetalia,,,32,174,206,37,0.000122
Shitting Rainbows,,,19,4,23,51,0.000064
Arguing on the internet,,,38,34,72,46,0.000082
Dear Cis People,,,10,40,50,7,0.000023
Menopause,,,11,13,24,39,0.000016
Run Chubby,,,10,11,21,9,0.000018
SPH,,,18,29,47,31,0.000051
I can swear!,,,4,49,53,50,0.000017
Tulpa,,,10,43,53,7,0.00003
Personal Pronouns,,,38,82,120,19,0.000045
Men's Rights Activist,,,63,96,159,19,0.000151
Mountain Dew,,,16,24,40,4,0.000054
JustinRPG,,,24,49,73,7,0.000072
Bitstrips,,,7,9,16,59,0.000034
I Dislike Cis People,,,26,97,123,7,0.000041
Thin Skin,,,39,74,113,7,0.000237
Assigned Male,,,16,137,153,19,0.000022
Lilypichu,,,10,66,76,41,0.000014
Britam,,,6,67,73,37,0.000014
Pussy-whipped,,,40,47,87,39,0.000033
Cougar,,,38,15,53,48,0.000101
Incest Archives,,,4,31,35,53,0.000036
Aimee Major Steinberger,,,1,53,54,28,0.000019
Cassiel,,,4,45,49,28,0.000013
Het,,,5,28,33,21,0.000017
Bishounen,,,24,27,51,28,0.000032
Sean Hannity,,,29,30,59,14,0.000141
Kazakai,,,7,70,77,28,0.000014
Ainsley Harriott,,,10,28,38,9,0.000017
Duke Nukem 3D,,,17,62,79,49,0.000044
Punk,,,110,118,228,12,0.000197
Gary Oak,,,59,38,97,9,0.000125
Creepy Woody,,,6,40,46,9,0.000014
City of Heroes,,,9,75,84,49,0.000019
Free Realms,,,17,95,112,49,0.00007
Friday,,,14,23,37,36,0.000079
Protest,,,27,23,50,14,0.000057
Star Wars: The Old Republic,,,4,15,19,33,0.000014
Final Fantasy XI,,,18,143,161,49,0.000025
Rogue,,,21,61,82,49,0.000034
Air Man ga Taosenai,,,1,6,7,9,0.000011
Aircraftkiller,,,2,17,19,38,0.000012
Password,,,17,39,56,14,0.000027
Has anyone really been far even as decided to use even go want to do look more like?,,,18,23,41,9,0.000078
Proboards,,,6,34,40,0,0.000014
Subtext,,,4,11,15,21,0.000014
Dongs,,,47,7,54,54,0.000119
Airplane,,,49,182,231,35,0.000129
Jet,,,8,20,28,12,0.000015
Arkansas,,,19,20,39,35,0.000027
West Virginia,,,26,208,234,35,0.000079
Condescension,,,13,4,17,35,0.000039
IKEA,,,13,14,27,35,0.000022
Brisbane,,,13,158,171,12,0.000025
Pauline Hanson,,,9,129,138,36,0.000049
Silicone,,,6,9,15,50,0.000014
Axilism,,,8,5,13,39,0.000033
Here Comes The Airplane,,,7,16,23,28,0.000069
Malaysia Airlines Flight 370,,,7,48,55,58,0.000033
Steven Slater,,,7,39,46,30,0.000038
TSA,,,21,46,67,37,0.000039
AishaxNekox,,,4,38,42,21,0.000014
I-heart-hikaru,,,8,59,67,21,0.000024
Scenewhore,,,35,36,71,12,0.000073
Quality,,,42,15,57,28,0.000044
Ramy,,,6,35,41,21,0.000013
Sonicrocksmysocks,,,25,91,116,28,0.000032
Sythyx,,,5,26,31,7,0.000011
Ajax,,,3,19,22,10,0.000019
Ajax (JavaScript),,,1,31,32,10,0.000011
JavaScript,,,25,37,62,10,0.000064
CSS,,,5,13,18,10,0.000018
Chemistry,,,17,40,57,35,0.000039
W3C,,,4,4,8,10,0.000029
Cleverbot,,,14,60,74,9,0.000034
Ajjantis,,,3,32,35,49,0.000012
Arnold Schwarzenegger,,,104,68,172,33,0.000131
Ajsiu,,,1,4,5,10,0.000016
Ajt,,,3,2,5,6,0.000024
Akafa,,,1,62,63,31,0.000011
The Blue Waffle,,,41,15,56,32,0.000057
Polyamory,,,34,26,60,8,0.000042
What he doesn't know can't hurt him,,,47,21,68,36,0.000062
Akai,,,1,2,3,21,0.000011
Akai Dalia,,,18,63,81,7,0.000023
Akaichou,,,2,54,56,21,0.000015
Obsession,,,81,36,117,8,0.00009
Manly Tears,,,18,28,46,28,0.00005
BlueshineWolf,,,21,75,96,24,0.000038
Pewdie-Pinkiepie,,,12,40,52,7,0.000032
Realmrsoptimusprime,,,39,165,204,19,0.000054
XOMizzEggManOx,,,6,44,50,7,0.000013
Angelic-Catalyst,,,15,87,102,32,0.000036
Erzascarlet8,,,6,66,72,38,0.000013
JINXDROWNED,,,11,69,80,7,0.000016
Joshy Furret,,,3,30,33,7,0.000012
Twincest,,,34,24,58,28,0.000069
The Ring,,,15,31,46,14,0.00002
AkewsticRockR,,,12,18,30,61,0.000027
LeisureSuitGaming,,,19,91,110,61,0.000027
Irate Gamer,,,67,125,192,61,0.000071
Akiane,,,1,25,26,46,0.000011
Fixed,,,29,26,55,9,0.000029
Controversy,,,31,9,40,2,0.000048
Akmal Shaikh,,,2,35,37,37,0.000014
Kung Fu,,,39,36,75,11,0.000086
Kevin Havens,,,26,112,138,50,0.000033
Aku Tojyo,,,2,8,10,31,0.000011
Akuryou,,,4,12,16,12,0.000031
Hardcore Dancing,,,5,19,24,12,0.000022
Al,,,0,18,18,53,0.000011
Al Sharpton,,,43,66,109,35,0.000065
Alan Cox,,,9,19,28,10,0.000022
Alan Moore,,,9,26,35,9,0.000021
Alan The Panda,,,10,40,50,31,0.000024
Alan Turing,,,15,35,50,40,0.000044
Alan Watt,,,3,2,5,46,0.000011
Alan Rice,,,2,11,13,7,0.000013
Alan Barnes,,,2,5,7,53,0.000012
Albert Einstein,,,46,47,93,46,0.000217
THEN AL WAS A ZOMBIE,,,2,8,10,9,0.000014
Weird Al Yankovic,,,33,68,101,12,0.000089
Saturday Night Live,,,53,60,113,17,0.000077
Chuck Schumer,,,4,12,16,19,0.000018
Cereal Guy,,,7,37,44,9,0.000042
Gorean,,,14,50,64,31,0.000043
Dan Quayle,,,14,19,33,14,0.000077
Dr. Seuss,,,7,40,47,53,0.000037
Serious Cat,,,26,12,38,9,0.000085
Mo Brooks,,,10,44,54,46,0.00005
Al Jazeera,,,0,9,9,37,0.000011
Bana Alabed,,,2,30,32,37,0.000012
Marcellus Williams,,,8,96,104,35,0.000014
Humanitarian,,,4,16,20,48,0.000018
Don Imus,,,16,58,74,35,0.000032
Transnigger,,,18,71,89,19,0.000032
Jesse Jackson,,,23,30,53,35,0.000031
John Holmes,,,6,22,28,40,0.000061
Gambling,,,44,101,145,35,0.000036
Kool-Aid,,,67,24,91,35,0.000131
Puerto Rico,,,35,92,127,35,0.000045
I Has a Bucket,,,28,3,31,9,0.000066
Jena Six,,,17,68,85,35,0.000037
Alabama,,,53,54,107,35,0.000072
Culture,,,31,47,78,37,0.000111
Death penalty,,,14,81,95,35,0.000043
Peanut Butter Jelly Time,,,15,15,30,9,0.000055
Flea Market Montgomery,,,15,28,43,9,0.000022
Amy Bishop,,,6,62,68,58,0.000024
Tim James,,,10,5,15,35,0.000034
Condoleezza Rice,,,15,22,37,14,0.000031
Alabaster,,,2,10,12,3,0.000011
Son of art,,,23,58,81,52,0.000048
Unreal Tournament,,,18,157,175,49,0.00002
Star Wars Galaxies,,,9,51,60,49,0.00002
The Elder Scrolls IV: Oblivion,,,35,116,151,49,0.000035
It is a mystery,,,120,21,141,19,0.000115
Hurr,,,66,24,90,19,0.000075
Beard,,,20,6,26,37,0.000025
MUD,,,17,37,54,31,0.000026
Engineer,,,39,76,115,11,0.000079
Red Hat,,,7,16,23,10,0.000027
Linus Torvalds,,,19,27,46,10,0.000056
Moore,,,1,3,4,14,0.000011
Wizard,,,20,23,43,19,0.000019
Jack the Ripper,,,23,76,99,37,0.000037
New Zealand Fail Guy,,,16,18,34,9,0.000107
Demon,,,38,33,71,46,0.000111
John Kricfalusi,,,23,68,91,34,0.00003
MJ,,,3,2,5,53,0.000011
Benito Mussolini,,,16,47,63,37,0.00004
Having A Wonderful Time,,,10,50,60,9,0.000022
AlanaJonze,,,2,10,12,38,0.000011
Hamtaro,,,13,13,26,28,0.000065
Mike Gravel,,,5,18,23,14,0.000016
Celts,,,7,40,47,37,0.000021
Kosovo,,,15,52,67,37,0.000026
Montenegro,,,4,28,32,37,0.000022
Roman Empire,,,61,120,181,37,0.000183
Nun,,,14,13,27,39,0.000068
Whiskey,,,10,18,28,35,0.000042
Packer,,,10,17,27,40,0.000019
Dyslexia,,,48,22,70,23,0.000104
Fetal Alcohol Syndrome,,,37,52,89,38,0.000084
Albino Blacksheep,,,7,20,27,4,0.000018
Animutation,,,9,28,37,4,0.000024
Lemon Demon,,,12,59,71,8,0.000021
The Young Ones,,,6,65,71,12,0.000022
Ann Coulter,,,128,50,178,14,0.000325
Hogville.net,,,2,7,9,40,0.000015
Crystal Head Vodka,,,12,27,39,17,0.000022
Kittens,,,62,0,62,25,0.00012
Hogging,,,7,16,23,52,0.000045
Internet military,,,24,20,44,1,0.000031
List of Terms Referring to a Woman's Period,,,15,37,52,39,0.000032
The Elder Scrolls V: Skyrim,,,46,217,263,49,0.00006
Cracker,,,83,12,95,35,0.000124
DGTrixie,,,15,82,97,44,0.000047
Steve Bannon,,,8,27,35,17,0.000032
Legal Drinking Age,,,2,71,73,35,0.000019
Drunk dial,,,10,20,30,8,0.000031
Decantering,,,5,10,15,9,0.000023
Shots,,,13,6,19,12,0.000035
Beeripedia,,,3,27,30,2,0.000019
Whale Safe Beer,,,5,14,19,52,0.000022
Texts From Last Night,,,5,24,29,18,0.000018
ITT Tech,,,34,51,85,26,0.000039
Chuggo,,,23,42,65,40,0.000066
Northern Ireland,,,14,44,58,37,0.000035
Party girl,,,35,17,52,36,0.000044
Teksoqp,,,3,8,11,9,0.000015
Kingscrusher,,,5,76,81,37,0.00004
Killhamster,,,31,19,50,52,0.000049
Cyndilovespiccolo,,,23,122,145,16,0.000067
Oclet,,,16,16,32,41,0.000082
Brandon Smith,,,10,34,44,53,0.000029
Awesome.jpg,,,5,4,9,6,0.000061
Skeezer,,,26,14,40,36,0.000074
Rehab,,,31,36,67,36,0.000037
Never drinking again,,,27,17,44,35,0.000052
Alec Difrawi,,,3,56,59,49,0.000016
Straw Man,,,37,39,76,46,0.000071
Telemarketers,,,12,23,35,37,0.000021
Aleeyah Porter,,,1,10,11,35,0.000013
Alek Minassian,,,3,31,34,58,0.000015
Justin Trudeau,,,17,38,55,19,0.000034
Android,,,38,81,119,10,0.000058
Armenians,,,56,75,131,37,0.000132
Incel,,,15,73,88,58,0.000017
Marjan Siklic,,,23,90,113,7,0.000077
False flaggot,,,18,17,35,61,0.000053
Tonetta,,,4,29,33,48,0.000019
Alektorophobic,,,1,2,3,1,0.000011
POE News,,,5,20,25,1,0.000017
MyTanookiSuitHasBalls,,,6,21,27,31,0.000019
Alenonimo,,,6,44,50,22,0.000013
Chick tracts,,,37,52,89,46,0.000061
Edarem,,,13,49,62,39,0.000038
Alex,,,1,27,28,7,0.000012
Alex Chiu,,,8,9,17,11,0.000024
Alex Ford,,,11,74,85,52,0.000024
Alex Linder,,,14,17,31,2,0.000021
Alex MacRae,,,3,16,19,48,0.000012
Alex Mae Muholland,,,15,37,52,7,0.000019
Marvin Morvan and Alex Teniola,,,1,15,16,35,0.000011
Alexander-sama,,,5,18,23,9,0.000012
Alexander4488,,,36,115,151,61,0.000074
AleximusPrime,,,1,12,13,7,0.000011
Alexis Arquette,,,7,35,42,63,0.000019
Alexreynard,,,9,82,91,31,0.000025
Alexus Lioness,,,4,3,7,7,0.000028
Alexyss Tylor,,,2,4,6,15,0.000011
Evil-unveiled.com/Alex Anders,,,2,2,4,43,0.000011
Evil-unveiled.com/Ohellyeah70,,,3,3,6,43,0.000013
AlexBluez,,,1,33,34,24,0.000012
AlexSavageOMFG,,,0,8,8,9,0.000011
Diaperfur,,,49,30,79,31,0.00009
Arthur Chu,,,28,111,139,19,0.000027
College Sex Bloggers,,,17,33,50,11,0.000096
Online Poker,,,9,58,67,23,0.000036
Utah,,,30,49,79,35,0.000051
CeLe,,,11,48,59,9,0.000026
Arbchat,,,30,9,39,2,0.000112
File:Aspirations.jpg,,,2,0,2,52,0.000011
LUElinks,,,11,27,38,3,0.000026
Pi,,,11,31,42,10,0.00004
Typing with one hand,,,11,27,38,18,0.000021
Chris Beer,,,9,11,20,9,0.000046
Rush Limbaugh,,,82,124,206,14,0.000131
Dinosaur,,,65,61,126,46,0.000183
Jerry Falwell,,,22,18,40,46,0.000028
Science Fiction,,,67,46,113,46,0.000087
Penn and Teller,,,19,73,92,46,0.000058
Keith Olbermann,,,33,131,164,14,0.000081
Butt boy,,,1,0,1,17,0.000011
"Francis E. Dec, Esq.",,,14,50,64,17,0.000022
Princess Diana,,,27,25,52,37,0.000051
Furluminati,,,46,32,78,31,0.000092
The Singing Shark,,,19,22,41,9,0.000044
Paul Joseph Watson,,,16,51,67,19,0.000026
Survivalist,,,12,32,44,4,0.000022
Avery Chicoine,,,14,101,115,30,0.000075
Zeitgeist - The Movie,,,7,49,56,17,0.00002
Sherry Shriner,,,12,115,127,17,0.000028
Xee-A Twelve,,,16,118,134,46,0.000044
Orly Taitz,,,14,39,53,14,0.000038
DELET THIS,,,3,0,3,19,0.000012
Alex Leal,,,0,8,8,19,0.000011
Dave Kelly,,,31,62,93,61,0.000052
Social Autopsy,,,6,27,33,19,0.000014
CuteYandereNeko,,,7,41,48,7,0.000013
Sos-Dcelli-Dl,,,3,20,23,7,0.000011
Alex Mauer,,,2,24,26,7,0.000017
Gender Bender DNA Twister Extreme,,,10,42,52,19,0.000027
The Great Chan Death of January 2007,,,5,20,25,9,0.000013
Caller ID Spoofing,,,10,25,35,26,0.000025
Alex Wuori/Logs,,,1,4,5,26,0.000012
Dork,,,26,7,33,10,0.000035
NationStates,,,6,218,224,14,0.000018
Hamtaro's Theory,,,8,15,23,2,0.000029
Dick Butt,,,22,22,44,9,0.000053
Alexander4488/Director Commentary,,,3,58,61,61,0.000011
Alexander4488/Approved ED Page,,,2,63,65,61,0.000011
Video Game Reviewers,,,89,330,419,61,0.000115
Jerry Seinfeld,,,51,50,101,17,0.000104
METOKUR,,,16,108,124,52,0.000017
Raymond45154,,,9,69,78,61,0.000024
Dude,,,18,9,27,49,0.000029
Message,,,11,13,24,12,0.000025
Armake21,,,19,18,37,61,0.000026
Alexander Jahans,,,2,6,8,14,0.000015
Feels Guy,,,16,32,48,9,0.000032
BritPol,,,4,39,43,19,0.000018
Eurovision,,,7,66,73,37,0.000016
Godhand Edit,,,34,37,71,49,0.000033
Alexander Slavros,,,2,20,22,58,0.000012
GameSpot,,,34,93,127,49,0.000083
Audiosurf,,,10,18,28,12,0.000014
Think B4 You Speak,,,7,28,35,40,0.000032
Alexandercarneiro,,,3,6,9,48,0.000012
Timmysmommy01,,,2,18,20,48,0.000012
The Sarkeesian Effect,,,13,115,128,19,0.000022
Alexis,,,1,7,8,63,0.000011
Sarina Valentina,,,8,14,22,63,0.000033
Evil-unveiled.com/Alexis77,,,3,6,9,43,0.000034
Lexi Bee,,,16,58,74,52,0.000031
The Wikipedia Jews,,,65,56,121,2,0.000109
Dissected-chan,,,18,24,42,22,0.000067
Formspring,,,18,68,86,13,0.00002
Auto-erotic asphyxiation,,,32,32,64,39,0.000062
Necro,,,10,3,13,41,0.000015
I DIDN'T EAT THAT FUCKIN SANDWICH OR THE TOILET THING EITHER!,,,14,18,32,9,0.000041
Schadenfreude,,,8,13,21,37,0.000031
Category:Drama-generating techniques,,,16,0,16,26,0.000057
Nancy Grace,,,1,15,16,58,0.000011
Blogosphere,,,15,104,119,26,0.000022
Find a Grave,,,13,23,36,58,0.000018
Mensa,,,13,39,52,10,0.000034
JonBenet Ramsey,,,14,55,69,18,0.000054
Perfection Girl,,,13,24,37,9,0.000016
Kidnapping,,,24,19,43,28,0.000041
Lisa Nowak,,,13,49,62,31,0.000038
InSaNe-REYNARD,,,25,107,132,31,0.000063
Rangerphile,,,33,151,184,31,0.000074
Pregfur,,,19,27,46,31,0.000037
Wet and Messy Fetishism,,,16,73,89,39,0.000033
B Walmer,,,8,50,58,31,0.000014
Ali,,,0,6,6,37,0.000011
Ali Akbar,,,2,10,12,35,0.000012
Ali Sina,,,3,53,56,37,0.000013
Rucka Rucka Ali,,,18,85,103,35,0.000052
Sith Lord Ali,,,2,31,33,8,0.000014
The Crusades,,,18,27,45,37,0.00003
Christopher Hitchens,,,30,57,87,37,0.000054
Geert Wilders,,,18,49,67,37,0.000036
Alibaba,,,0,26,26,11,0.000011
Hello Kitty,,,45,50,95,28,0.000141
Shoe,,,23,5,28,10,0.000091
Bath Salts,,,10,7,17,35,0.000016
Lead,,,8,4,12,37,0.000027
Some Guy,,,15,24,39,8,0.000022
Alice,,,1,6,7,43,0.000011
Alice Margatroid,,,6,37,43,28,0.000015
Wikichan/Ten-year-old Alice,,,2,0,2,43,0.000012
Wikichan/Alice and the rape zombies,,,1,0,1,43,0.000012
Evil-unveiled.com/Alice Day,,,7,1,8,43,0.000051
Evil-unveiled.com/Visions of Alice,,,46,8,54,43,0.000201
Area 51,,,22,32,54,17,0.000036
Ayy lmao,,,9,15,24,9,0.000025
Secret Squirrel,,,20,43,63,14,0.000043
E.T.,,,12,33,45,49,0.000024
Raelism,,,20,71,91,46,0.000049
Internap,,,3,11,14,8,0.000019
Aliens: Colonial Marines,,,0,8,8,49,0.000011
Dreamcast,,,19,54,73,49,0.000026
Alignment,,,8,4,12,9,0.00002
Alisa Kuzmenko,,,2,27,29,25,0.000016
Final Fantasy VI,,,21,130,151,29,0.000115
Rat,,,50,92,142,25,0.000087
Alison,,,39,70,109,2,0.000056
Alison (disambiguation),,,1,5,6,13,0.000011
SlimVirgin,,,68,55,123,2,0.000127
Jaranda,,,32,61,93,2,0.000025
Frog,,,18,25,43,49,0.000069
Phaedriel,,,27,43,70,2,0.000056
Wikipedese,,,18,52,70,2,0.000095
Amorrow,,,15,72,87,2,0.000021
Fake editor,,,33,25,58,2,0.000074
DerHexer,,,8,11,19,2,0.000017
The Wikipedia Review,,,84,89,173,2,0.000086
Hivemind,,,55,18,73,2,0.000086
NawlinWiki,,,32,150,182,2,0.000039
ED Government,,,5,4,9,2,0.000048
Johnny the Vandal,,,9,35,44,2,0.000014
Marry Your Pet,,,19,33,52,31,0.000035
AlisonPrime,,,4,29,33,19,0.000012
TheRalphRetort,,,17,150,167,19,0.000017
Icze4r,,,2,58,60,7,0.000011
JonTron,,,32,96,128,19,0.000047
ZilianOP,,,6,48,54,46,0.000048
Netoraserare,,,7,79,86,19,0.000012
Alison Floyd,,,2,27,29,35,0.000015
Allison Daniels,,,2,59,61,13,0.000015
Allison Stokke,,,4,27,31,8,0.000013
Ruination,,,149,41,190,26,0.000195
Penni-piper,,,3,20,23,18,0.000012
Polygon,,,21,1,22,19,0.000024
Happycat,,,28,35,63,9,0.000078
Destructoid,,,21,72,93,19,0.000019
Alison Rapp/Quotes and posts,,,1,0,1,19,0.000011
Todd Nickerson,,,5,2,7,19,0.000019
Salon,,,21,122,143,19,0.000051
HeartMob,,,6,40,46,19,0.000013
Male Gaze,,,9,34,43,39,0.00002
Alix Henriol,,,14,24,38,7,0.000028
Crackwhore,,,37,17,54,36,0.000086
It was a social experiment,,,69,10,79,41,0.000099
Antipsychotic Drug,,,8,33,41,17,0.000016
Max Hardcore,,,23,69,92,39,0.000082
Alizée,,,3,12,15,18,0.000016
All-Star Whiners,,,3,18,21,13,0.000019
Purelily,,,38,43,81,46,0.000145
PaigeGirl,,,15,44,59,8,0.000045
Synthetikmisery,,,13,13,26,8,0.000039
AllAbout-SP,,,5,26,31,0,0.000015
Whatisthematrix77,,,1,0,1,0,0.000011
AllAbout-SP/Knixfan33208,,,1,1,2,41,0.000011
Piczo,,,5,14,19,21,0.000016
AllAbout-SP/whatisthematrix77,,,1,0,1,0,0.000011
Circlist,,,4,23,27,47,0.000013
Chaosscizzors,,,6,16,22,28,0.000018
Booru,,,20,49,69,28,0.000065
Tonsaphunshizah,,,4,9,13,28,0.000016
AllTheFallen.ninja/Shoutbox,,,1,0,1,28,0.000012
AllTheFallen.ninja/Emails,,,1,0,1,28,0.000012
Ulithium Dragon,,,3,5,8,28,0.000014
Dancing with Smurfs,,,55,195,250,33,0.0001
All Gen Gamers,,,3,31,34,61,0.000011
All In The Family,,,3,10,13,34,0.000015
Base,,,1,3,4,25,0.000014
Stargate,,,8,38,46,15,0.000023
POV,,,24,10,34,2,0.000102
PROJECT CHANOLOGY/IRL PROTEST PAGE/IDES OF MARCH,,,15,21,36,26,0.000042
All is Brawl,,,3,80,83,49,0.000011
Too cool for the Internet,,,17,67,84,51,0.000156
Marvel vs. Capcom 2: New Age of Heroes,,,7,32,39,49,0.000013
Way before the internets,,,3,10,13,37,0.000019
Moses,,,16,14,30,37,0.000036
Tunak,,,8,26,34,37,0.00006
E-Jihad,,,16,5,21,37,0.000045
Fitlads,,,8,122,130,40,0.000038
Wolf,,,38,77,115,31,0.000054
Shaming,,,25,6,31,19,0.000027
Troll art,,,42,73,115,21,0.000048
E621,,,17,39,56,31,0.000044
Fchan,,,36,64,100,31,0.000058
DariusHunter,,,9,73,82,31,0.000015
Jasonafex,,,6,76,82,31,0.000028
Jason Ball,,,2,25,27,31,0.000011
Paradisefreedom,,,9,86,95,31,0.000039
Sibe,,,15,51,66,31,0.000034
Sniff Heinkel,,,10,81,91,31,0.000049
Allan Bell,,,0,38,38,40,0.000011
Peter Pan,,,14,37,51,53,0.000036
Dickhead,,,37,27,64,40,0.000055
Go fuck yourself,,,42,6,48,49,0.000196
Steve Ballmer,,,20,12,32,10,0.000053
Back Orifice,,,5,11,16,10,0.000017
Mangina,,,58,20,78,16,0.000089
Alle,,,1,28,29,8,0.00002
Angyl,,,21,62,83,9,0.000043
Botnet,,,38,29,67,10,0.000065
Allecto,,,4,38,42,26,0.000011
Gunt,,,7,13,20,16,0.000019
Firefly,,,27,48,75,19,0.000049
Fiction,,,49,14,63,46,0.000146
Meele,,,17,16,33,8,0.000073
Nomadlisa,,,6,10,16,8,0.000023
Ghostlight,,,25,41,66,8,0.00008
Allendsin,,,4,30,34,37,0.000015
Carp,,,1,1,2,27,0.000011
Suicide Girls,,,46,69,115,18,0.000074
Allendsin/Chat log,,,1,5,6,52,0.000011
Cunnilingus,,,80,37,117,36,0.000192
Allie Kibby,,,2,138,140,36,0.000032
Convention,,,99,46,145,31,0.000143
Con,,,17,6,23,36,0.000055
Conscience,,,5,9,14,16,0.000022
Breaking Up,,,19,70,89,36,0.000028
Stinkrat,,,11,40,51,25,0.000022
User:Mu.ollin/Succubus,,,3,0,3,7,0.000012
User:Kashiwaba Tomoe,,,20,0,20,37,0.00003
Drama queen,,,98,51,149,8,0.00013
Polygamy,,,38,28,66,37,0.000084
Faghag,,,30,9,39,40,0.000045
Hotard,,,20,14,34,36,0.000095
Bruce Jenner,,,40,43,83,19,0.000072
Hauntings,,,8,13,21,19,0.000029
Buffy the Vampire Slayer,,,43,68,111,42,0.000098
Bunnydragoon,,,4,10,14,36,0.000014
Comic-Con,,,8,63,71,13,0.000021
Maryjane,,,3,9,12,36,0.000014
Alligator,,,7,28,35,34,0.000026
You don't have any friends,,,151,49,200,8,0.000137
Hipocrite,,,39,54,93,2,0.000046
Usagi Kou,,,17,35,52,28,0.000031
Kalidor,,,2,7,9,34,0.000012
Free Republic,,,13,65,78,14,0.000045
X-Warlock,,,2,7,9,34,0.000013
FIRRIB,,,2,19,21,34,0.000013
AlmightyLOL,,,2,32,34,49,0.000012
Interflop,,,2,15,17,9,0.000011
Identity theft,,,30,16,46,3,0.000045
Teamspeak,,,7,9,16,49,0.000016
Ventrilo,,,10,18,28,49,0.000016
Almighty Pillage,,,7,9,16,41,0.000024
Almost-Chan,,,2,16,18,9,0.000011
"Don't Date Him, Girl",,,7,13,20,39,0.000019
Tyler,,,4,13,17,58,0.000016
BitingBeaver/RapeChecklist,,,4,12,16,39,0.00002
Mexicanicepick,,,10,39,49,39,0.000032
Zarna Joshi,,,20,32,52,19,0.000041
Ashley Todd,,,8,64,72,14,0.000034
Charlotte E. Smith,,,11,17,28,39,0.000027
Cock Trapper,,,32,19,51,36,0.000053
Girl Drama,,,39,27,66,52,0.000176
Girl you must be a...,,,3,6,9,39,0.000015
Jackie Coakley,,,21,31,52,39,0.000053
Kesha,,,55,389,444,36,0.000061
Rape Checklist,,,21,153,174,39,0.000075
Rape Clock,,,36,1,37,39,0.000074
Almost rapped,,,12,20,32,12,0.000033
Popular belief,,,28,27,55,40,0.000085
Jodie Foster,,,10,26,36,42,0.00002
Viper,,,8,20,28,35,0.000033
Alpha geek,,,7,10,17,10,0.000034
IPod,,,96,95,191,10,0.000177
Alphawerewolff,,,9,38,47,31,0.000018
Don Henrie,,,35,65,100,27,0.000101
Trolls Trolling Trolls,,,115,76,191,41,0.000224
Lizziey,,,7,61,68,8,0.000019
Zoe Kimball,,,9,44,53,9,0.000029
Alra Galathor,,,1,19,20,37,0.000011
Nexopia,,,7,20,27,4,0.000026
Alt-0173,,,1,11,12,9,0.000011
Alt-Lite,,,3,14,17,19,0.000013
Kekistan,,,11,23,34,19,0.00002
Armoured Skeptic,,,8,33,41,19,0.000017
Alt-Porn,,,16,89,105,18,0.000041
Internet Model,,,38,57,95,36,0.000055
Fake Bisexual,,,26,44,70,12,0.000038
Burning Angel,,,8,27,35,36,0.000012
BioShock,,,40,174,214,49,0.00007
Lithium Picnic,,,7,29,36,18,0.000016
Zeta Toy,,,45,34,79,31,0.000129
Baby Sinead,,,5,15,20,18,0.000011
Aries,,,11,16,27,36,0.000033
ModelMayhem,,,20,114,134,40,0.000041
Vanessa Alexandra,,,9,37,46,18,0.000017
Hunter S. Thompson,,,25,47,72,41,0.000041
David Duke,,,5,25,30,17,0.000028
Anne Wheaton,,,4,21,25,19,0.000027
Alt.fan.karl-malden.nose,,,5,10,15,41,0.000023
Alt.syntax.tactical,,,4,17,21,41,0.000013
Meow Wars,,,17,22,39,41,0.000044
Wikibreak,,,21,17,38,2,0.000023
Alt.tasteless,,,7,44,51,22,0.000013
Your Email/Geoff Miller's Epic Flame,,,1,0,1,22,0.000011
Mythbusters,,,12,23,35,22,0.000076
Michael Everson,,,3,18,21,46,0.000017
Scroll up,,,9,4,13,9,0.000055
Shitlord,,,17,28,45,19,0.000025
Loud Nigra,,,15,21,36,48,0.000038
The Burden of Proof,,,87,16,103,3,0.000124
Bleeding,,,1,0,1,38,0.000011
James Randi,,,16,84,100,46,0.000025
Snap,,,8,9,17,38,0.000015
Fallacious reasoning,,,47,73,120,46,0.000069
Pain (Physical),,,10,75,85,6,0.000027
Skullgirls,,,13,94,107,49,0.00002
Alucard27,,,3,22,25,49,0.000016
Faggoth,,,42,30,72,12,0.000056
Black Veil Brides,,,4,54,58,12,0.000034
Capcom,,,41,70,111,49,0.000029
Devil May Cry,,,10,81,91,49,0.000017
Short man syndrome,,,12,18,30,26,0.000036
Capcom BBS,,,3,30,33,49,0.000012
Alvin-Earthworm,,,9,92,101,62,0.000024
Fox,,,55,43,98,31,0.000132
Wilkins Coffee,,,26,60,86,34,0.000034
Oh ok,,,25,32,57,13,0.000091
Lulz in hell Trollfags,,,14,44,58,31,0.000017
Haters gonna hate,,,50,14,64,9,0.000061
Basil Marceaux.com,,,5,49,54,56,0.000014
Miss Teen South Carolina,,,12,28,40,35,0.000019
Michael Berry,,,6,31,37,14,0.000019
Alyallie,,,5,24,29,28,0.000012
Yandere,,,12,38,50,22,0.000023
Alynna Vixen,,,3,39,42,31,0.000011
Drama awesome,,,4,12,16,31,0.000014
Trepanation,,,12,37,49,12,0.000076
Alyssa,,,5,20,25,34,0.000013
Chat Palace,,,6,81,87,60,0.000022
Special:Search,,,2,0,2,39,0.000012
Mary Bell,,,7,30,37,39,0.000036
Femen,,,6,60,66,36,0.00003
Alyssa Rosales,,,4,16,20,31,0.000013
Haters Make Me Famous,,,40,60,100,12,0.00005
Alzheimer's,,,9,28,37,1,0.000019
Omegle,,,31,76,107,18,0.000166
The Most Interesting Man In The World,,,8,33,41,9,0.000018
Bant/,,,4,38,42,9,0.000013
Amalea,,,26,47,73,8,0.000091
DNS Comic,,,17,15,32,54,0.000124
Userinfo,,,14,17,31,8,0.000056
WHOIS,,,17,7,24,41,0.000034
Ricochet rabbit,,,9,28,37,8,0.000026
Vapid twat,,,9,12,21,8,0.000022
English is not my native language,,,13,26,39,10,0.000027
Amanda,,,0,11,11,36,0.000011
Amanda Kijera,,,2,13,15,35,0.000013
Amanda Wenk,,,4,18,22,3,0.000016
Wank,,,64,7,71,8,0.000075
Lexus Amanda,,,4,3,7,36,0.000012
HAARP,,,17,39,56,17,0.000021
Robbie Farah,,,5,16,21,36,0.000014
Charlotte Dawson,,,5,22,27,36,0.000024
Mario Laudicina,,,5,53,58,64,0.000016
Bandwidth,,,23,19,42,8,0.000037
"Amarillo, TX",,,0,6,6,41,0.000011
Amateur porn,,,17,21,38,39,0.000039
Swingers,,,16,124,140,2,0.000019
Amazingplatypus69,,,2,40,42,31,0.000011
Wolfeedarkfang,,,43,184,227,31,0.000033
FurryOps,,,13,65,78,31,0.000013
Butt plug,,,26,17,43,6,0.000037
Dave Eggers,,,8,34,42,41,0.000025
Gary Weiss,,,19,22,41,2,0.000038
Kindle,,,3,16,19,35,0.000014
Amazon Disaster,,,2,14,16,64,0.000014
Amazon Wish List,,,2,27,29,6,0.000014
Amber Baird,,,1,28,29,25,0.000012
Amber Buttrum,,,6,23,29,52,0.000013
Project Freeweb,,,14,107,121,26,0.000033
Amber Buttrum/Beefrave Logs,,,1,0,1,52,0.000011
Amberdrake,,,8,35,43,31,0.000028
Kiminess,,,6,25,31,31,0.000023
Amberdrake/Whores,,,1,3,4,31,0.000011
Kamilya,,,2,7,9,31,0.000014
Ambrose Bierce,,,8,46,54,1,0.000021
Oscar Wilde,,,13,3,16,1,0.000029
William Randolph Hearst,,,7,72,79,1,0.000017
William Tecumseh Sherman,,,17,25,42,26,0.000094
America's Harvest Box,,,0,29,29,35,0.000011
Title IX,,,5,100,105,19,0.000016
America's Third Party,,,14,71,85,14,0.000039
Kent Hovind,,,13,40,53,46,0.000021
VonHelton,,,22,175,197,17,0.00012
George Zimmerman's Big Game Hunter,,,13,26,39,35,0.000019
America is Not a Fucking Country,,,1,10,11,9,0.000016
America is Racist,,,5,48,53,35,0.000022
Fop,,,3,14,17,40,0.000012
Michael Moore,,,68,76,144,14,0.000195
Magical Trevor,,,6,5,11,44,0.000013
Anti-Americanism,,,17,30,47,14,0.000045
AmericanDad86,,,9,33,42,2,0.000036
Tyciol,,,45,62,107,43,0.000079
Bobby Kotick,,,23,27,50,49,0.000025
American English,,,16,4,20,37,0.000042
Penthouse,,,2,20,22,22,0.000013
BoycottMcDonalds.com,,,3,17,20,40,0.000016
Electric Retard,,,9,34,43,21,0.000016
Mississippi,,,27,33,60,35,0.000038
Jesus is Savior,,,4,52,56,46,0.000011
Focus on the Family,,,10,65,75,46,0.000022
Sanjaya,,,15,48,63,29,0.000022
Britain's Got No Fucking Talent,,,14,38,52,29,0.000045
Pants on the ground,,,4,23,27,9,0.000012
American Psychiatric Association,,,3,6,9,30,0.000016
Luring,,,18,6,24,1,0.000079
JailbaitGallery.com,,,13,19,32,35,0.000042
Ferrari Guy,,,8,63,71,57,0.000025
Map,,,1,2,3,10,0.000016
The Chaser,,,12,51,63,14,0.000028
Sabu,,,26,21,47,10,0.000062
Suburbs,,,65,57,122,12,0.000112
South America,,,26,16,42,35,0.000045
POS,,,11,10,21,39,0.000037
Burger King,,,60,29,89,41,0.00008
Nikola Tesla,,,17,43,60,47,0.000083
TonyTigerGate,,,7,18,25,31,0.000017
Milk Bags,,,31,8,39,9,0.000094
They,,,15,10,25,3,0.000058
Gravity,,,7,25,32,39,0.000026
Otto Warmbier,,,10,72,82,37,0.000047
Pindos,,,10,29,39,37,0.000033
Amethe,,,1,5,6,31,0.000011
Rubberfur,,,14,27,41,31,0.000035
August Yifu,,,12,74,86,31,0.000024
Amiga,,,19,19,38,10,0.000032
Eric W. Schwartz,,,12,67,79,31,0.000024
Amiibo,,,8,21,29,7,0.000018
Amipregnant,,,12,12,24,8,0.000029
Iworshipsatin,,,11,23,34,8,0.000043
Vaginal warrior,,,1,0,1,8,0.000013
Teenmommies,,,13,13,26,8,0.000025
Amish,,,2,17,19,58,0.000012
Amorous Professor Cherry,,,3,8,11,36,0.000012
Malber,,,13,27,40,2,0.000032
Wikimania,,,10,11,21,2,0.000018
Morrowind,,,13,116,129,49,0.000018
Mistress Selina Kyle,,,11,19,30,2,0.000021
Linuxbeak,,,13,34,47,2,0.000022
Kevin Mitnick,,,30,52,82,10,0.000042
Eunuch,,,17,19,36,37,0.000025
Dead baby dumping,,,6,21,27,1,0.000015
Bobby Boulders,,,10,23,33,2,0.000014
Amourshipping,,,1,6,7,28,0.000013
Amp,,,2,37,39,6,0.000013
Wang Jue,,,16,40,56,25,0.000026
Shock Site/Discharges,,,12,12,24,6,0.000048
Stile Project,,,20,60,80,6,0.000022
Encyclopedia Dramatica:Stub,,,27,0,27,13,0.000119
Crystal (disambiguation),,,1,10,11,36,0.000014
Caffeine,,,12,38,50,13,0.000028
Rudy Eugene,,,11,18,29,35,0.000033
Breaking Bad Comics,,,4,29,33,9,0.000015
Duckface,,,42,54,96,59,0.000093
DeviantART Iconsplz,,,10,9,19,21,0.000015
Guy Macon's original post,,,10,12,22,50,0.000042
Lens flare,,,75,34,109,21,0.000117
Justflyakite,,,4,105,109,21,0.000012
Amy's Baking Company,,,16,52,68,19,0.000027
Gordon Ramsay,,,17,53,70,52,0.000064
Threats of violence,,,21,44,65,2,0.000032
Toilet,,,35,7,42,37,0.000045
Yelp.com,,,5,31,36,11,0.000014
Fifty Shades of Grey,,,36,168,204,39,0.000043
TMZ,,,15,33,48,32,0.000021
Venn diagram,,,8,15,23,46,0.000026
"Amy, Sally, and Mina",,,2,48,50,21,0.000013
Sonbreezie,,,5,25,30,21,0.000024
Amy-The-BoomHog32,,,1,1,2,21,0.000011
Amy Alkon,,,1,40,41,8,0.000012
Auto-fellatio,,,47,22,69,21,0.000096
"Sadly, No!",,,5,7,12,14,0.00002
Glock,,,10,2,12,58,0.000018
Mr. T,,,16,46,62,35,0.000036
Amy Dickinson,,,2,27,29,41,0.000011
Amy Schumer,,,34,54,88,19,0.000117
Sarah Silverman,,,22,43,65,17,0.000048
Lena Dunham,,,49,200,249,19,0.000149
BAHDUM TISH,,,10,16,26,17,0.000024
College Humor,,,11,35,46,61,0.000017
Amy Steele,,,1,32,33,30,0.000015
Cock Block,,,71,66,137,36,0.000066
Valleywag,,,9,17,26,1,0.000017
Because of my syndrome,,,24,32,56,52,0.000046
Riley34470,,,18,149,167,48,0.000058
Amyloup,,,0,15,15,31,0.000011
Balto,,,1,0,1,31,0.000011
Paw,,,1,0,1,31,0.000011
Animation,,,1,0,1,31,0.000011
Animation Source,,,4,68,72,31,0.000016
Where is your X now?,,,26,21,47,9,0.000052
Easter egg,,,13,9,22,49,0.000031
Jake Roberts,,,16,64,80,58,0.000037
Daniel Petric,,,3,34,37,49,0.000012
An Heroine,,,19,60,79,1,0.000048
Christine Chubbuck,,,4,18,22,58,0.000029
Emma Jones,,,3,35,38,39,0.000017
Gabrielle Molina,,,1,16,17,58,0.000011
Hannah Bond,,,9,36,45,12,0.000033
Jenny Grant,,,4,55,59,36,0.000027
Phoebe Prince,,,3,21,24,13,0.000013
Rachele Rudd,,,2,26,28,1,0.000012
Sadie Davila,,,1,38,39,21,0.000011
An Herpo,,,3,27,30,32,0.000012
Lollercoaster,,,66,45,111,48,0.000215
Criss Angel,,,10,30,40,12,0.000035
Jolene JRyda,,,18,91,109,51,0.000107
Rudolph Zurick,,,2,11,13,58,0.000026
MacBook Air,,,6,20,26,10,0.000033
Ben Vodden,,,10,33,43,58,0.00003
Christopher Reeve,,,10,26,36,13,0.00005
The An Heroes of Bridgend,,,12,45,57,13,0.000036
Ricardo Lopez,,,12,48,60,58,0.000034
Samuel Hengel,,,2,44,46,13,0.000027
Jaylen Fryberg,,,6,15,21,58,0.00003
Shuaiby,,,6,30,36,19,0.000028
Mitchell Heisman,,,2,32,34,46,0.000026
Ricky Rodriguez,,,3,27,30,53,0.000027
Stiletto Null,,,1,12,13,40,0.000026
My Hero Academia,,,3,17,20,28,0.000026
Ana 4 avril,,,6,21,27,8,0.00003
Karma,,,29,9,38,34,0.000044
Ana Voog,,,4,13,17,8,0.000012
Plskthx,,,18,2,20,8,0.000036
Tim McLean,,,9,37,46,51,0.000026
Go-,,,6,42,48,51,0.000016
SerialKillaC,,,4,18,22,51,0.000013
Anailaigh,,,7,39,46,31,0.000033
Anakata,,,7,13,20,10,0.000017
Korean cry,,,5,24,29,36,0.000018
R000t,,,8,26,34,10,0.00002
Anal Prolapse,,,19,1,20,58,0.000064
Guts,,,4,13,17,22,0.000084
Analogy,,,4,38,42,58,0.000021
Tyler Peterson,,,5,26,31,58,0.000018
Soul Calibur,,,13,80,93,39,0.000014
AnandTech,,,2,45,47,10,0.000014
Angel,,,22,34,56,46,0.000049
Hotmail,,,6,5,11,10,0.000015
Anarchists,,,13,6,19,4,0.000036
The Anarchist Cookbook,,,14,31,45,4,0.000036
Text Files,,,20,54,74,4,0.000043
Anarchists (LiveJournal community),,,5,22,27,8,0.000018
Nevin Zehr,,,4,30,34,8,0.000012
Anarchochan,,,3,5,8,35,0.000014
Ashlee Simpson,,,19,51,70,12,0.000054
R0x0rs,,,1,0,1,14,0.000012
Kazaa,,,13,18,31,53,0.00003
XD,,,12,2,14,37,0.000018
List of articles Beta M copied from BoyWiki and pasted on Anarchopedia,,,2,0,2,6,0.000012
Illogicopedia,,,14,11,25,2,0.000028
Arborphilia,,,28,13,41,14,0.000064
Giant Enemy Crabs,,,28,1,29,49,0.000039
The Fury,,,14,14,28,49,0.000015
PSP,,,29,54,83,49,0.000035
Bat,,,1,6,7,9,0.000011
Online sex games,,,20,48,68,28,0.000036
Anasutashiaxkinpouge,,,0,17,17,24,0.000011
Ancestry.com,,,2,25,27,15,0.000015
Ancient Realms,,,2,7,9,9,0.000012
Drshnaps Productions,,,2,77,79,15,0.000012
And Fuck You Anyway,,,7,11,18,49,0.000015
Dan Schneider,,,18,50,68,34,0.000051
Deadname,,,19,33,52,19,0.000041
Bane,,,37,84,121,9,0.000039
Unabomber,,,27,46,73,58,0.00005
Political science,,,5,11,16,2,0.000013
Erik Ribsskog,,,13,68,81,35,0.000045
Scouse,,,13,62,75,42,0.000026
Mark Essex,,,15,41,56,35,0.000049
PeanutFreeMom,,,4,39,43,41,0.000012
The Hidden Wiki,,,8,63,71,13,0.000023
Fembusters/Leslie Jones' Twitter Meltdown,,,13,66,79,19,0.000057
Andi Dier,,,0,8,8,19,0.000011
Transphobia,,,20,64,84,19,0.000035
Andikins,,,4,17,21,52,0.00002
Recovered,,,12,6,18,8,0.000028
Andouillette,,,6,17,23,22,0.000039
Haribo® Sugarless Gummy Bears,,,13,22,35,34,0.000092
Andrea Dworkin,,,4,27,31,19,0.000035
Exploding Whale,,,8,5,13,9,0.000053
Squirting,,,14,11,25,36,0.000027
Candwich,,,2,6,8,14,0.000012
Andreaurbanfox,,,1,64,65,3,0.000012
Trent Reznor,,,32,82,114,12,0.00009
Last.FM,,,25,68,93,12,0.000041
The Catcher in the Rye,,,6,30,36,12,0.000024
Andrew Allred,,,5,36,41,8,0.000015
Fagnostic,,,10,52,62,40,0.000024
Confession,,,13,21,34,14,0.000024
Goons,,,48,13,61,50,0.000045
Something Awful Sycophant Squad,,,18,29,47,8,0.000024
PLZ ADVZ,,,3,51,54,46,0.000011
Andrew Allred/Maddox chatlog,,,1,3,4,8,0.000011
Andrew Allred/Threw me convo,,,1,2,3,8,0.000011
Bald,,,53,8,61,19,0.000078
Manlet,,,16,36,52,58,0.000032
Master Trole,,,2,11,13,9,0.000011
Bakla,,,12,7,19,40,0.000026
Roosh V,,,17,26,43,19,0.000024
Video Game Journalism,,,9,23,32,19,0.000015
Andrew Breitbart,,,7,10,17,19,0.000021
Rachel Maddow,,,10,56,66,14,0.00004
Sebastian Bosse,,,9,64,73,58,0.000023
Andrew Brunell,,,5,18,23,41,0.000013
IP Relay,,,2,11,13,38,0.000016
Pity Sex,,,33,16,49,19,0.000031
Noozle on a Doozle,,,1,9,10,36,0.000012
Andrew Kehoe,,,4,27,31,58,0.000013
Andrew Koenig,,,2,12,14,63,0.000012
Vancouver,,,13,42,55,11,0.000033
Andrew Oswalt,,,0,21,21,19,0.000011
Dat boi,,,4,5,9,19,0.000018
Andrew Quah,,,10,19,29,14,0.000018
Liberal Party of Australia,,,16,78,94,14,0.000111
Andrew Quah/Chatlog,,,1,0,1,14,0.000011
Reputation Defender,,,16,51,67,11,0.000029
BLACK MAN,,,30,16,46,41,0.000056
Blockatiel,,,31,29,60,9,0.000067
Googlecash,,,18,14,32,26,0.000032
Bigot,,,17,18,35,19,0.000041
Operation Restoring Truthiness,,,11,36,47,14,0.000015
Rick Sanchez,,,15,81,96,14,0.000028
Scott Thomas Beauchamp,,,3,33,36,37,0.000012
Black People Love Us!,,,14,5,19,35,0.000035
Rummy,,,16,21,37,37,0.000055
BigMuscle,,,4,48,52,40,0.000011
Andrew show,,,2,13,15,31,0.000015
Usher,,,1,0,1,31,0.000012
ChristianHillbilly,,,29,24,53,46,0.000065
Sereza,,,5,7,12,31,0.000021
Prussian Blue,,,23,42,65,17,0.000039
Salj,,,15,25,40,8,0.000034
Santa Rosa,,,2,25,27,3,0.000017
Sloth,,,9,4,13,54,0.000056
Deceased Encyclopedia Dramaticians,,,14,21,35,58,0.000045
Hyakynthos,,,4,21,25,13,0.000016
Tethering,,,2,18,20,10,0.000012
Super Nintendo,,,38,27,65,49,0.000038
SEGA,,,34,37,71,49,0.000035
Bing,,,10,17,27,10,0.000039
Snugglenets,,,7,27,34,41,0.000037
SSH,,,7,26,33,10,0.000019
Gay.pl,,,26,24,50,10,0.000104
"I, for one, welcome our new X overlords",,,4,22,26,9,0.000017
Internet Kill Switch,,,10,37,47,14,0.00002
Killer,,,9,34,43,10,0.000038
T-Mobile,,,3,57,60,10,0.000014
Fairphone,,,3,16,19,10,0.000014
Android Hunter A,,,1,28,29,39,0.000011
Internet Panhandling,,,11,56,67,48,0.000019
Andy Maher,,,5,22,27,53,0.000023
Andy Maher/logs,,,2,1,3,53,0.000012
Andy Milonakis,,,6,22,28,12,0.000016
Comedian,,,16,32,48,17,0.00003
Tom Green,,,26,103,129,9,0.000071
Andy Schlafly,,,17,76,93,46,0.000046
Nobel Prize for Racism,,,13,99,112,37,0.000026
Mike Huckabee,,,19,85,104,14,0.000028
Attack,,,44,15,59,2,0.000042
Failfags,,,11,31,42,37,0.00009
Andy Zebrowitz,,,1,6,7,10,0.000012
Drexel University,,,6,50,56,3,0.000017
Anecdotal evidence,,,6,14,20,8,0.000027
Belt0033,,,9,21,30,8,0.000027
Aneros,,,6,33,39,46,0.000123
BeastPaint,,,14,30,44,31,0.000032
Rfjason,,,21,13,34,8,0.000074
North American DONG Party,,,7,45,52,54,0.000047
Angband,,,4,24,28,49,0.000013
Y helo thar,,,23,7,30,3,0.000082
Nethack,,,4,11,15,49,0.000016
EDopoly,,,13,11,24,10,0.000023
Quasidan's Penis,,,12,32,44,8,0.000019
Pillow Angel,,,14,81,95,56,0.000026
Angel Meiru,,,14,50,64,31,0.000016
Inflation art,,,109,89,198,31,0.000127
Angel Meiru forum logs,,,1,4,5,2,0.000011
Pullip,,,7,26,33,28,0.000016
Auchimura,,,15,46,61,31,0.000015
Dragonbreeder,,,13,38,51,31,0.000014
Dragomike,,,25,83,108,31,0.000021
MeleeKirby,,,19,67,86,31,0.000026
Mikemedia,,,16,28,44,31,0.000016
Mxbot,,,12,31,43,31,0.000014
Rubbertex Raccoon,,,19,27,46,31,0.000018
Tolstoy,,,22,52,74,31,0.000021
TrufflesforYou,,,13,32,45,31,0.000014
Two-Ton-Neko,,,15,50,65,31,0.000015
Virus-20,,,22,79,101,31,0.000021
Zero Whitefang,,,15,42,57,31,0.000014
ZS3,,,15,46,61,31,0.000015
Angela,,,13,3,16,2,0.000023
Angela Beesley Starling,,,21,23,44,2,0.000056
Angela Sazanow,,,2,9,11,36,0.000018
Angela Beesley Starling/Unicode,,,1,0,1,2,0.000013
Erik Möller,,,25,45,70,2,0.000037
Wikia,,,73,93,166,2,0.000087
Liberal Butthurt Syndrome,,,35,44,79,14,0.000121
Success,,,42,12,54,32,0.000046
My Tiny Dick,,,56,43,99,63,0.000127
Brainwashing,,,36,44,80,26,0.000034
Hyperblade53,,,4,33,37,32,0.000013
Onyx Forepaw,,,12,56,68,52,0.000029
Onigojirakaiju,,,45,117,162,24,0.000111
Mimikayuko,,,9,45,54,21,0.000017
Azure-Neon,,,14,25,39,21,0.000041
Kaoru Yuuka,,,27,138,165,28,0.000066
Angelique DeSatanos,,,3,19,22,36,0.000014
Shay,,,42,36,78,52,0.000116
Violence,,,104,46,150,37,0.000137
Breeder,,,62,40,102,40,0.000148
Open relationship,,,8,27,35,36,0.000013
Professor Edward Stabbington,,,5,6,11,2,0.000018
"Slander, Slander Salamander",,,15,23,38,8,0.000026
Internet guilty,,,9,3,12,52,0.00002
Deflamation,,,6,7,13,48,0.000017
DivineAngel,,,46,74,120,21,0.000108
Dong Mosaic,,,6,7,13,54,0.00002
Lolcano,,,32,11,43,48,0.000145
Missy,,,2,90,92,35,0.000013
Seph Lawless,,,4,87,91,35,0.000026
OurFancy,,,5,30,35,52,0.000031
Angels Corps,,,3,12,15,22,0.000017
Dave Cheung,,,8,85,93,22,0.000021
Dolcett,,,6,26,32,22,0.000022
Natalie Portman,,,13,60,73,17,0.000116
Lotion Play,,,6,20,26,39,0.000014
PissedOffVideoGamer,,,18,42,60,61,0.000054
Gary Yourofsky,,,9,30,39,25,0.000017
Tourette's Guy,,,62,81,143,34,0.000073
Burger the Angry Cat,,,13,33,46,25,0.000028
Kirbyraeg,,,13,16,29,9,0.000039
Feelings,,,11,25,36,13,0.000017
Angie,,,6,114,120,52,0.000018
Angie Varona,,,6,25,31,36,0.000013
Farming,,,4,11,15,35,0.000019
Mentos in diet soda,,,2,18,20,10,0.000016
I have a 140 IQ,,,40,27,67,11,0.000144
EHarmony,,,12,24,36,46,0.000017
Google Translator,,,5,6,11,37,0.000012
Online relationship,,,10,27,37,52,0.000013
Colombia,,,32,93,125,35,0.000055
ILY,,,4,18,22,50,0.000021
Guriin,,,3,16,19,9,0.000011
Ashley Greene,,,6,9,15,36,0.000016
AngryLittleGiri,,,4,37,41,46,0.000014
Blasphemy Challenge,,,6,15,21,46,0.000015
Honorz,,,22,10,32,48,0.00002
Violetkitty411,,,42,81,123,48,0.000071
Paperlilies,,,11,31,42,48,0.000016
Angry Asian Man,,,7,50,57,11,0.000024
Toshiro Mifune,,,4,43,47,11,0.000021
Asianface,,,17,14,31,11,0.000023
Tori Sue Heck,,,41,66,107,21,0.000137
Starbucks,,,24,6,30,15,0.000032
The Black Sentinel,,,1,2,3,11,0.000011
Billy Hatcher and the Giant Egg,,,2,33,35,7,0.000011
Bird is the word,,,9,15,24,9,0.000019
CAW CAW,,,4,6,10,9,0.000011
YOU'RE A BIRD!,,,33,52,85,9,0.000058
Angry Gay Pope,,,3,18,21,26,0.00003
Tim Armer,,,4,31,35,26,0.000015
Shart,,,10,10,20,34,0.000018
Floppy disk,,,33,4,37,35,0.000051
MMORPG Freak Out,,,13,35,48,49,0.000022
Cansin13,,,8,31,39,28,0.000019
Multiculturalism,,,20,0,20,37,0.000032
Microsoft Office,,,13,7,20,10,0.000043
McJuggerNuggets,,,8,78,86,23,0.000014
Smile.jpg,,,12,12,24,22,0.000025
Nintendo Switch,,,12,28,40,49,0.000027
Jared Milton,,,19,46,65,40,0.000065
BlueCatRiolu,,,31,111,142,7,0.000053
Charlie Check'm,,,7,58,65,40,0.000015
CRoadwarrior,,,3,15,18,38,0.000012
Barry Bonds,,,5,33,38,35,0.000016
Angry Joe,,,16,75,91,61,0.000018
JewWario,,,13,16,29,61,0.000016
Machinima,,,26,69,95,49,0.000047
Christoph Naumova,,,3,38,41,31,0.000011
Hollie Toups,,,5,28,33,61,0.000013
Julianneirace,,,4,90,94,0,0.000014
Zero Punctuation,,,30,101,131,49,0.000035
Lulzkiller,,,29,1,30,48,0.000022
Tool,,,77,64,141,12,0.000074
Fist of the North Star,,,19,67,86,28,0.000034
Jfreedan,,,18,95,113,61,0.000026
TheArchfiend,,,23,67,90,24,0.000037
Doug Walker,,,27,103,130,61,0.000047
Fembusters/Paul Feig,,,10,9,19,19,0.00002
Mansplain,,,7,14,21,39,0.000018
Ben Kuchera,,,9,91,100,19,0.000036
Rog & Tyrone,,,9,11,20,19,0.000014
Game Grumps,,,21,49,70,19,0.00002
Internet DVD,,,7,30,37,61,0.000013
MonkeyGameGuides,,,11,39,50,7,0.00002
ScrewAttack,,,19,61,80,61,0.000035
Angryhatred,,,0,11,11,8,0.000011
Fake journal,,,21,14,35,8,0.000077
Anonymous pussy,,,42,20,62,8,0.000252
Angryjedi,,,0,9,9,28,0.000011
MadThad0890,,,13,62,75,28,0.000023
Visual Novel,,,16,5,21,28,0.000018
Delicious flat chest,,,18,43,61,28,0.000056
Nathan Keefer,,,8,134,142,21,0.000032
The Student Room,,,4,109,113,47,0.000018
Stream of consciousness,,,41,16,57,8,0.000066
AngusNitro41,,,7,46,53,21,0.000022
Shadowfox118,,,5,32,37,21,0.000012
Internet petition,,,24,12,36,19,0.000028
AngusNitro41/IRClogs,,,1,1,2,21,0.000011
LinktheWolf,,,8,34,42,21,0.000016
IRONAS,,,14,64,78,21,0.000025
Gimpyd,,,1,9,10,41,0.000011
LazyTown,,,48,84,132,53,0.000091
Teamdouche,,,9,18,27,9,0.000012
Hammer,,,13,6,19,24,0.000038
The Juggernaut,,,15,23,38,49,0.000015
Angyl/General Info,,,1,10,11,9,0.000011
AniRoleplay,,,3,35,38,28,0.000011
Sword Art Online,,,5,66,71,28,0.000012
Elitist role players to casuals,,,1,0,1,28,0.000011
Sittin On Tha Toilet,,,32,44,76,21,0.000113
Scared Monkey,,,3,6,9,29,0.000014
Lolrus,,,33,29,62,48,0.00019
Badger Badger Badger,,,21,21,42,44,0.000052
Cyberpets,,,9,110,119,44,0.000026
Hamster,,,24,9,33,25,0.000046
Horse,,,41,17,58,41,0.000059
Koko The Gorilla,,,6,23,29,35,0.000031
Animal Dreams,,,6,21,27,8,0.000016
Brutal honesty,,,5,11,16,8,0.000016
Mengus,,,6,8,14,8,0.000015
LJ User Secrets,,,6,7,13,8,0.000018
Qweerdo,,,5,10,15,8,0.000015
Animal Dreams/Brutal honesty,,,1,4,5,55,0.000011
Animal Dreams/Brutal drama,,,1,5,6,55,0.000011
Animal Jam,,,0,24,24,31,0.000011
Club Penguin,,,24,68,92,31,0.000039
Furcadia,,,49,133,182,31,0.000081
Experiment,,,1,0,1,25,0.000011
Happy Snake,,,8,4,12,9,0.00003
Vegan Rebuttal,,,5,31,36,25,0.000015
Dave Warwak,,,6,39,45,25,0.000016
Earth First,,,5,39,44,25,0.000014
Showing Animals Respect and Kindness,,,4,30,34,25,0.00002
Specism,,,12,16,28,31,0.00003
Vader,,,4,21,25,19,0.000018
Animal Wilson,,,1,40,41,52,0.000013
Loki Blackfang,,,1,32,33,31,0.000011
Placeholder,,,3,11,14,26,0.000016
Neil Patrick Harris,,,15,60,75,40,0.000026
Oliver Hart,,,4,0,4,52,0.000014
Glee,,,15,76,91,36,0.00002
Milk,,,29,28,57,50,0.000085
Goddess Bunny,,,9,14,23,28,0.000045
Turtle Punch,,,8,7,15,47,0.000032
Bacon,,,29,30,59,17,0.000037
Japanese Bug Fights,,,26,76,102,25,0.000054
Ron Mexico,,,41,85,126,35,0.000082
David Motari,,,23,60,83,37,0.00003
Courage Wolf,,,11,11,22,9,0.000044
Cutoutdissection.com,,,1,38,39,30,0.000012
Dalavesta,,,18,34,52,31,0.00006
Zoophilia.net,,,11,43,54,31,0.000032
Animaljail,,,5,29,34,21,0.000011
Tasmania,,,6,36,42,60,0.000016
Animaniacs,,,15,36,51,34,0.000016
Anthrocon,,,48,56,104,31,0.000047
Sony-Mae,,,24,118,142,21,0.000042
AnimatedJames,,,15,77,92,7,0.000041
Teen Titans,,,43,50,93,34,0.000047
Sonmanic,,,52,178,230,15,0.000094
SaturnDOS,,,16,93,109,7,0.000021
Hacking Team,,,13,153,166,23,0.000037
Cycle of Blame,,,6,5,11,8,0.000023
Animated Foot Scene Wiki,,,1,15,16,34,0.000011
The Amazing World of Gumball,,,13,45,58,34,0.000019
The Loud House,,,28,70,98,34,0.00003
Bastard,,,33,22,55,27,0.000043
Sleeping,,,1,0,1,31,0.000011
Whore before,,,1,0,1,31,0.000011
Nakouwolf,,,1,2,3,37,0.000011
Username,,,1,0,1,31,0.000011
MushyMutt,,,2,46,48,31,0.000011
C4tspajamas,,,2,29,31,38,0.000011
Anime Amnesty,,,1,10,11,28,0.000011
Yotsuba,,,9,7,16,9,0.000026
Anime Haters,,,2,12,14,19,0.000018
European Martial Arts,,,4,1,5,19,0.00002
Anime News Network,,,5,29,34,28,0.000014
Zac Bertschy,,,7,19,26,28,0.000022
Colony Drop,,,18,59,77,28,0.00009
San Antonio,,,7,42,49,35,0.000023
Jesuotaku,,,4,15,19,28,0.000013
Anime Physics,,,9,19,28,28,0.000019
Animu archetypes,,,17,119,136,28,0.000026
Anime Theme,,,5,20,25,28,0.000018
Chekhov's Gun,,,7,37,44,34,0.000018
Deus Ex Machina,,,19,43,62,34,0.000039
Fan dub,,,10,24,34,28,0.000019
Hardware,,,1,0,1,28,0.000011
Crisis,,,1,0,1,28,0.000011
Anime is Satan,,,2,25,27,28,0.000017
Animegao,,,10,38,48,28,0.000039
Otakukin,,,43,118,161,28,0.000046
Yosuga No Sora,,,12,48,60,28,0.000085
X in my pants,,,5,55,60,39,0.000012
Porygon,,,8,44,52,28,0.000025
Vagina Dentata,,,16,19,35,39,0.000037
Mullet,,,19,35,54,37,0.000041
Pantyshot,,,79,33,112,28,0.000098
Love Hina,,,13,38,51,28,0.000027
Otaku emoticons,,,6,16,22,28,0.00003
Pisoga,,,2,17,19,6,0.000016
Sushi,,,5,17,22,52,0.000018
Sailor Moon,,,102,148,250,28,0.000109
Ouran High School Host Club,,,14,47,61,28,0.000036
Rosario + Vampire,,,11,87,98,28,0.000032
Parasyte - the Maxim,,,5,28,33,28,0.000018
Hellsing,,,26,86,112,28,0.000034
Higurashi,,,10,26,36,28,0.000019
Zoids,,,7,56,63,28,0.000018
Ghost in the Shell,,,7,28,35,28,0.00002
Fullmetal Alchemist,,,40,130,170,28,0.000068
R@ygold,,,30,20,50,48,0.000096
Archer,,,11,78,89,37,0.000039
D.Gray-Man,,,9,80,89,28,0.000025
Gendou,,,3,7,10,28,0.000017
Pixelmari,,,4,33,37,28,0.000024
Silk Screen Goku Shirt,,,13,23,36,28,0.000048
Sisero,,,1,6,7,28,0.000016
Teruaki Murakami,,,4,31,35,28,0.000027
Vicki Sigh,,,10,53,63,19,0.000038
Critter,,,10,70,80,31,0.000023
Slash,,,36,25,61,10,0.000078
Seto-Kaiba.com,,,17,147,164,51,0.000032
Final Fantasy VIII,,,13,78,91,29,0.000104
Castlevania,,,31,129,160,49,0.000033
Gendo Pose,,,10,16,26,28,0.000018
RIKI-OH,,,14,41,55,39,0.000031
Eat attack,,,4,3,7,49,0.000013
Kirbyslover,,,5,41,46,38,0.000012
Y!Gallery,,,20,91,111,21,0.000049
Anjel,,,6,67,73,31,0.000028
"♥",,,41,40,81,52,0.00011
Ponyland Catfights,,,6,30,36,52,0.000012
Evil-unveiled.com/Scapegoat,,,9,2,11,43,0.000045
Enlightenment,,,16,53,69,46,0.000033
Anjem Choudary,,,5,50,55,37,0.000019
English Defence League,,,9,21,30,37,0.000016
UAF,,,2,26,28,39,0.000012
Socialist Workers Party,,,5,83,88,13,0.000023
Pre-op,,,1,0,1,14,0.000016
Drudge Report,,,14,30,44,14,0.000042
John Edwards,,,18,66,84,14,0.000034
Evil-unveiled.com,,,17,18,35,10,0.000048
Penis envy,,,25,13,38,39,0.000044
Atlasshrugs2000,,,15,83,98,37,0.000028
Debbie Schlussel,,,2,21,23,52,0.000017
Ann Liv Young,,,10,36,46,36,0.000026
Anna Beshnova,,,5,61,66,37,0.000016
Rusty Rockets,,,11,47,58,36,0.000034
Orvillecopter,,,9,49,58,14,0.000025
Anna Anthropy,,,4,10,14,19,0.000012
BoingBoing,,,20,88,108,42,0.000059
Tanja Fleischer,,,2,43,45,24,0.000011
Anna Chapman,,,7,68,75,37,0.000019
The Steganographers,,,10,46,56,37,0.000016
I Hope Nobody Has Hacked The Stream,,,4,27,31,9,0.000015
Social engineering,,,33,19,52,10,0.000041
Phishing,,,44,20,64,10,0.000053
Dot.com,,,1,0,1,37,0.000011
Txt msg,,,17,27,44,10,0.000023
Rox-Yin & Kira,,,3,74,77,31,0.000012
Anna Kendrick,,,1,10,11,23,0.00003
Body,,,3,5,8,17,0.000013
Annaliese Nielsen,,,1,7,8,19,0.000012
Annalise Walliker,,,7,37,44,12,0.000031
Melbourne,,,17,71,88,12,0.000029
Aqua Dots,,,9,8,17,39,0.000018
Sydney,,,14,39,53,59,0.000025
Annatar Scott,,,2,7,9,32,0.000011
Anne,,,0,31,31,8,0.000011
Anne Frank,,,21,7,28,37,0.000048
Anne Onymous,,,8,40,48,26,0.00003
Annie K,,,1,19,20,8,0.000011
Jeni Ann,,,8,20,28,36,0.000013
Lynn Ann,,,8,43,51,58,0.000025
Anniesj,,,3,9,12,8,0.000016
YukiKazamura,,,3,4,7,12,0.000015
Elgorgo,,,10,43,53,8,0.000027
Boytaur,,,18,15,33,31,0.000036
Statuephilia,,,15,50,65,50,0.000039
Rosie O'Donnell,,,54,39,93,19,0.000163
Rice out,,,10,26,36,27,0.000033
Wil Wheaton,,,7,49,56,19,0.000017
Fanfic lesbians,,,16,21,37,21,0.000039
Annotum,,,4,65,69,2,0.000017
Boobpedia,,,9,60,69,2,0.000035
LaraLove,,,22,125,147,2,0.000024
GFDL,,,6,5,11,2,0.000013
Criteria for Speedy Deletion,,,21,57,78,2,0.000028
Larry Sanger,,,30,30,60,2,0.000079
Annoying,,,45,2,47,7,0.000041
Annoying Facebook Girl,,,7,11,18,9,0.000037
AnoEx,,,4,46,50,48,0.000011
Namefagging,,,44,17,61,9,0.000049
AnokChan,,,4,6,10,46,0.000013
Bitching,,,1,0,1,46,0.000012
Poll's closed,,,3,13,16,11,0.000032
Bookchan,,,1,16,17,24,0.000011
AnonIB/Full text of the closure notice,,,2,1,3,6,0.000011
AnonNet,,,6,59,65,26,0.000014
Leaderfag,,,18,8,26,26,0.000046
ChancePsych,,,4,42,46,48,0.000011
Stu Wyatt,,,4,2,6,26,0.000012
Hampster Dance,,,14,23,37,9,0.000025
Facefag,,,17,19,36,9,0.000033
Sassia,,,1,11,12,56,0.000011
SHIT IT OFF,,,7,14,21,9,0.000025
Gene Simmons,,,16,41,57,17,0.00007
Anonops/Logs,,,1,0,1,10,0.000013
Mercedes Haefer,,,3,15,18,10,0.000028
AnonSec,,,1,1,2,10,0.000012
Kimmo Alm Emails,,,3,8,11,9,0.000014
GodJesus,,,18,14,32,46,0.00003
"You, sir, are and idiot :)",,,1,26,27,9,0.000012
X is now a meme,,,38,15,53,9,0.000078
Spambot,,,15,22,37,35,0.000032
Tehbigtoaster,,,16,68,84,48,0.000036
Dangerous Kitten,,,15,9,24,10,0.000062
Minichan,,,6,5,11,9,0.000022
Minichan BBS,,,11,74,85,9,0.000029
AnonTalk/The Book of Kimmo,,,1,0,1,9,0.000012
Softpaw Magazine,,,26,65,91,31,0.000088
Anonempires,,,3,39,42,26,0.000013
David,,,18,38,56,26,0.000059
Cyber Nations,,,6,65,71,1,0.000013
AnoniDate,,,9,12,21,28,0.000016
Dice,,,9,15,24,18,0.000031
AnoniWork,,,3,10,13,15,0.000014
Anonmgur,,,2,14,16,48,0.000011
PHP,,,25,23,48,10,0.000049
Reaction.jpg,,,6,14,20,9,0.00003
Anonnation,,,5,8,13,26,0.000012
Anonymous/Original,,,2,186,188,26,0.000024
Justin Bieber Hates Koreans,,,6,43,49,26,0.000028
LOIC,,,29,45,74,10,0.000073
SQL Injection,,,9,8,17,10,0.000033
SOHH,,,9,40,49,26,0.000033
Whatis-theplan,,,3,61,64,26,0.000027
Safe Space,,,46,41,87,19,0.00006
RPG,,,71,17,88,49,0.000089
The Well-Cultured Anonymous,,,7,36,43,26,0.000037
AnonymousThought,,,8,15,23,26,0.000025
Hunter Fyffe,,,4,27,31,9,0.000044
Internet Vigilante Group,,,33,53,86,26,0.000056
Operation Madeupname,,,7,49,56,14,0.000026
Self aware,,,18,36,54,48,0.000033
Uncle Anon,,,11,28,39,9,0.000059
ZanderJGavin,,,8,65,73,19,0.00003
John Solomon,,,16,41,57,26,0.000033
Mark Twain,,,14,46,60,26,0.00004
Immortal,,,12,33,45,12,0.000018
Lemmings,,,19,39,58,26,0.000035
JezuzFreek777,,,15,49,64,46,0.000043
Neowin,,,6,111,117,38,0.000014
Sea Org,,,20,20,40,26,0.000025
Tim Couch,,,2,13,15,26,0.000011
Dead Friend,,,22,42,64,12,0.000062
Strikethrough,,,24,6,30,34,0.000139
Undo,,,5,10,15,24,0.000019
TRON Guy,,,12,99,111,2,0.000025
AnonymousNasty,,,3,44,47,26,0.000011
Stop Posting,,,47,32,79,9,0.000056
Anonymous Anomaly,,,1,12,13,0,0.000011
Moaned,,,1,0,1,0,0.000011
Gigaloader,,,12,15,27,26,0.000037
Lulz.i8,,,2,7,9,9,0.000012
Humane weapons,,,6,44,50,9,0.000014
XyriX,,,4,68,72,9,0.000019
Anonymous Hijack NASA Slogan,,,5,15,20,9,0.000017
F5,,,12,14,26,8,0.000018
NASA,,,16,40,56,17,0.000032
Anonymous Playbook,,,6,2,8,26,0.000015
Tibet,,,27,38,65,11,0.000051
Defriend,,,27,49,76,8,0.000056
"No offense, but...",,,3,27,30,8,0.000029
Anti-anonymous,,,2,96,98,26,0.000021
Another-Realm,,,1,14,15,7,0.000011
Wwwarea,,,11,99,110,7,0.000016
HappyCabbie,,,15,71,86,48,0.000065
He11sing920,,,16,81,97,61,0.000037
Anphony,,,3,9,12,41,0.000013
Guerrilla News Network,,,5,19,24,41,0.000018
Anscathmarcach,,,2,79,81,46,0.000011
Shitty Attack Article,,,37,7,44,2,0.000051
Sonneillonsakarabru,,,1,66,67,49,0.000011
Helen Keller,,,3,6,9,46,0.000011
Personal army request,,,1,0,1,46,0.000011
Preachingthegospel,,,5,116,121,46,0.000012
Anshe Chung,,,3,19,22,8,0.000013
Cyber Rape,,,13,62,75,8,0.000015
Answerbag,,,3,34,37,14,0.000028
Megan's Law,,,9,22,31,39,0.000022
Anthony,,,0,24,24,7,0.000011
Wop,,,59,26,85,57,0.000092
Japancommercials4U2,,,1,56,57,49,0.000011
Anthony Merino,,,5,13,18,22,0.000019
Anthony Stancl,,,4,55,59,53,0.000015
Tony Abbott,,,8,61,69,14,0.000138
Tony Alamo,,,6,75,81,39,0.00002
Tony Blair,,,48,75,123,37,0.000089
Tony Eveready,,,16,12,28,36,0.000104
Tony FurryFox,,,2,0,2,7,0.000011
Tonystockert,,,11,21,32,48,0.000015
Friends of A-Log,,,31,265,296,7,0.000088
Anthony 'A-Log' LoGatto/A-Log's Fanfiction,,,6,29,35,7,0.000014
Anthony 'A-Log' LoGatto/Fanfiction/The World's Luckiest Guy/Main story,,,2,5,7,7,0.000012
Anthony 'A-Log' LoGatto/Fanfiction/The World's Luckiest Guy/Standalone stories,,,3,8,11,7,0.000012
"Anthony 'A-Log' LoGatto/Fanfiction/31 Tricks, 31 Treats",,,3,13,16,7,0.000013
Invisible Crane,,,5,46,51,41,0.000012
Ickeriss69,,,40,157,197,7,0.000042
Child Abduction,,,25,18,43,34,0.000111
Tard,,,35,2,37,7,0.000051
PC,,,69,7,76,49,0.000126
TMI,,,22,11,33,7,0.000037
Sailormoonred1,,,11,32,43,7,0.000018
Trollsona,,,7,28,35,7,0.000038
Open mic,,,2,17,19,13,0.000017
Cory Williamson,,,14,10,24,31,0.000046
Pedo Scarface,,,12,34,46,53,0.000035
Jam It In,,,45,14,59,28,0.000108
Samurai Jack,,,12,54,66,34,0.000021
Socially Awkward Penguin,,,15,20,35,9,0.000029
Chris-chan/Tomgirl Saga,,,5,49,54,7,0.000018
Spengbab,,,45,45,90,9,0.000079
Chyna,,,21,41,62,15,0.000051
Halloween,,,53,113,166,46,0.0001
Mewtwo,,,16,60,76,31,0.000028
NOT THE BEES,,,8,14,22,9,0.000017
Prank Call,,,39,57,96,26,0.000054
Voice Acting Alliance,,,4,30,34,28,0.000012
Dating sim,,,22,42,64,28,0.000035
Anthony 'A-Log' LoGatto/Fanfiction/The World's Luckiest Guy,,,3,0,3,7,0.000012
Inuboy1000,,,7,35,42,7,0.000014
Sons of Kojima,,,7,50,57,7,0.000015
Supreme Court,,,19,43,62,19,0.000063
Centrist,,,7,33,40,14,0.000013
Clinton,,,17,5,22,19,0.000048
Joe Kennedy,,,1,53,54,19,0.000011
Stag Party,,,6,5,11,15,0.000012
The Krassenstein Brothers,,,1,67,68,19,0.000011
Bernie Goetz,,,1,39,40,35,0.000011
Diversity Russian Roulette,,,1,65,66,19,0.000011
Fish,,,23,7,30,10,0.000058
Social networking sites,,,106,37,143,19,0.000146
Anthonytoney,,,5,7,12,21,0.000016
Matrooko11,,,9,31,40,34,0.000031
Anthrochat,,,6,5,11,31,0.000012
Gayfaggotinc,,,3,26,29,8,0.000014
Uncle Kage,,,7,48,55,31,0.000013
"Can't let you do that, StarFox!",,,12,13,25,31,0.000028
Theoretical Physics,,,14,36,50,46,0.000039
Anti-CNN,,,6,50,56,11,0.000016
Companion cube,,,1,0,1,11,0.000011
Anti-Encyclopedia Dramatica.com,,,13,86,99,21,0.000066
Suede Bear,,,6,24,30,31,0.000019
MarkyVigoroth,,,6,42,48,21,0.000014
Anti-Flagger Association of YouTube,,,1,18,19,0,0.000011
Anti-Goatse Law,,,2,4,6,14,0.000013
Anti-Vaxxers,,,4,43,47,17,0.000013
Pop parenting,,,32,40,72,8,0.000065
Heather Ann Murray,,,1,13,14,17,0.000011
Diddling,,,1,0,1,26,0.000011
Ninjas vs. Pirates,,,18,59,77,28,0.000061
Size queen,,,14,23,37,36,0.000048
Gears of War,,,33,118,151,49,0.000084
VampireFreaks,,,40,153,193,12,0.00006
The LURKMORE wiki,,,11,11,22,9,0.000042
May 2007,,,3,4,7,1,0.000024
MeganSpeaks,,,54,215,269,36,0.000294
The View,,,9,19,28,39,0.000026
Rachelle Waterman,,,25,21,46,8,0.00006
IAWTC,,,6,14,20,8,0.000039
Emoscene.com,,,8,27,35,12,0.000055
Dane Cook,,,60,71,131,17,0.000218
ELE,,,1,47,48,40,0.000019
Do You Want To Play With My Balls,,,7,29,36,1,0.000055
"You Bawww, You Lose",,,13,25,38,9,0.000061
Meaningless noise,,,25,19,44,8,0.000027
Breitbart,,,15,15,30,19,0.00003
Jayjg,,,32,21,53,2,0.000052
Easter,,,26,26,52,46,0.000064
Not Jewish,,,8,24,32,37,0.000039
Metzizah b'peh,,,18,21,39,17,0.000047
Happy Merchant/Merchant Face,,,38,44,82,19,0.000084
AntiDisneyMovement,,,3,29,32,16,0.000012
Anti Wulfhere Front,,,4,18,22,12,0.000012
Anti anti hentai club,,,2,22,24,53,0.000018
Promotion,,,18,10,28,9,0.00002
Anti vegan,,,2,24,26,25,0.000012
Person of Color,,,3,10,13,19,0.000012
Daniel Sieradski,,,6,34,40,19,0.000016
Kyle Chapman,,,3,11,14,19,0.000013
Leftypol/,,,3,34,37,19,0.000013
Lobotomy,,,6,25,31,13,0.000013
Humanmonkeyrace,,,5,7,12,30,0.000029
ValisHD,,,18,89,107,19,0.000044
Socializing,,,6,55,61,32,0.000026
T-Pain,,,26,15,41,12,0.000029
Sweet Brown,,,10,11,21,35,0.000019
Anton,,,2,11,13,9,0.000011
Mr. Saari,,,16,35,51,58,0.000032
"David ""Walky"" Willis",,,5,17,22,19,0.000018
Doug Winger,,,8,35,43,31,0.000032
Antonie Dixon,,,2,17,19,35,0.000012
Squirrelking,,,24,27,51,49,0.000021
Jerry Peet,,,12,141,153,7,0.000023
Science Pirate,,,7,7,14,1,0.00002
Demethos,,,3,2,5,1,0.000013
Anuebunnie/logs,,,1,3,4,1,0.000011
M. Chaos,,,12,45,57,21,0.000016
Anvil God,,,2,25,27,9,0.000011
Transformice,,,2,47,49,9,0.000011
Original Poster,,,16,46,62,9,0.000164
AnxietyCzar,,,0,1,1,2,0.000011
Anyone can edit,,,4,34,38,2,0.000017
"This is a wiki so I will vandalize it, thanks.",,,4,5,9,2,0.000014
Wikipedian,,,12,1,13,2,0.000032
Irssi,,,11,17,28,10,0.000056
Dau.pl,,,12,9,21,10,0.000069
Aomehigurashi258,,,1,6,7,28,0.000011
Assassination,,,19,21,40,19,0.000026
Timecop,,,12,7,19,41,0.000029
L0de,,,8,23,31,41,0.000024
Internet jail,,,28,10,38,8,0.00004
Guinea Pig,,,13,42,55,22,0.000029
Stingray,,,9,10,19,3,0.000017
Objectophilia,,,20,26,46,22,0.000046
Israeli apartheid,,,1,8,9,2,0.000011
Eugene Terreblanche,,,3,36,39,35,0.000013
Apartment 18,,,0,6,6,21,0.000011
MDetector5,,,6,146,152,21,0.000017
Apathy Dog,,,13,10,23,9,0.000023
Macro,,,40,6,46,9,0.000177
Nostradamus,,,17,46,63,14,0.000022
Bus Uncle,,,13,41,54,9,0.000025
Ghost Riding,,,6,45,51,35,0.000015
David Hasselhoff,,,15,30,45,36,0.000058
Ragnaröfl,,,10,15,25,41,0.000026
Apophis,,,6,12,18,46,0.000014
The Sun,,,16,3,19,46,0.000024
Apostrophe,,,1,8,9,3,0.000015
App,,,1,8,9,10,0.000012
They Live,,,13,16,29,17,0.000031
Reality Distortion Field,,,5,11,16,10,0.00002
Crapp,,,6,5,11,10,0.000057
Do i have potential,,,36,14,50,9,0.000055
Toilet Seat,,,24,27,51,39,0.000109
PowerPC,,,1,15,16,10,0.000014
BOLO,,,5,10,15,49,0.000017
Steve Jobs fanfiction,,,3,3,6,10,0.000019
Oregon Trail,,,32,27,59,35,0.00005
Jeff Goldblum is Watching You Poop,,,12,0,12,17,0.000038
GG Allin,,,21,50,71,50,0.000049
Kevin Rose,,,5,22,27,0,0.000019
Virii,,,9,5,14,53,0.000025
User:Fl0ss,,,2,0,2,10,0.000014
Lowter,,,3,31,34,40,0.000014
List of Macintosh exclusive games,,,1,0,1,10,0.000014
Woz,,,16,15,31,10,0.000026
Superpower,,,6,40,46,37,0.000024
OSx86,,,3,25,28,10,0.000016
AppleBirdie,,,1,13,14,7,0.000011
Source Filmmaker,,,9,54,63,49,0.00002
Jewbacca,,,8,16,24,48,0.000013
Dick Ants,,,15,10,25,9,0.00011
Godzilla,,,34,195,229,34,0.00007
Disc jockey,,,1,0,1,48,0.000011
Screencap,,,76,43,119,21,0.000111
Eye bleach,,,29,9,38,22,0.00006
MRirian,,,29,57,86,51,0.000085
Bear Grylls,,,9,21,30,9,0.000037
Approval Guy,,,7,14,21,9,0.000014
Lolscenequeens,,,7,35,42,36,0.000013
Eproctophilia,,,86,32,118,34,0.000112
April Furs Day,,,7,29,36,31,0.000018
April Winchell,,,3,19,22,8,0.000012
Etsy,,,12,47,59,12,0.000027
April Winchell/Commentary,,,1,5,6,8,0.000011
Blaming China,,,19,57,76,11,0.000039
GHB,,,15,15,30,39,0.000046
R. Lee Ermey,,,28,84,112,13,0.000055
Multiple personality disorder,,,41,34,75,36,0.000054
Ionotter,,,4,15,19,31,0.000012
Aquagirlwhitefox,,,6,13,19,31,0.000032
Yuethedragon,,,9,70,79,21,0.000016
Aquaman,,,5,57,62,38,0.000012
Lobo,,,4,18,22,34,0.000014
Wyatt Mann,,,46,62,108,19,0.000075
Gayniggers from Outer Space,,,26,26,52,41,0.000035
Waterboarding,,,9,13,22,22,0.000016
Penn State Scandal,,,17,76,93,39,0.000034
Scalies,,,32,29,61,31,0.000046
LaTeX,,,13,21,34,56,0.000028
Balloon Fetish,,,16,46,62,22,0.000032
Aquilus,,,2,48,50,40,0.000011
Cheat,,,25,4,29,38,0.000031
Internet Settlement,,,6,18,24,48,0.000067
Arbcom AUSC,,,2,7,9,2,0.000013
MBisanz,,,1,34,35,2,0.000012
Arbcom BASC,,,2,7,9,2,0.000013
Wikiwarfare,,,9,26,35,2,0.000041
Completely irrelevant history,,,33,19,52,2,0.00013
ISP,,,16,3,19,37,0.000055
Phil Sandifer,,,11,27,38,2,0.000018
Cplot,,,6,16,22,2,0.000027
Esperanza,,,6,22,28,2,0.000019
FT2,,,8,21,29,2,0.000017
Poetlister,,,23,46,69,2,0.000035
Talk page,,,24,5,29,2,0.000079
Mark Pellegrini,,,6,32,38,2,0.000017
Tomb Raider,,,53,92,145,32,0.000116
David Gerard,,,32,51,83,2,0.000053
Sam Blacketer,,,6,13,19,2,0.000016
Tiptoety,,,5,7,12,2,0.000017
Featured article,,,18,101,119,2,0.000021
Caroljoy,,,7,18,25,8,0.000019
Arbitration Committee/History,,,1,26,27,2,0.000012
Rebecca,,,20,22,42,2,0.000049
Sannse,,,4,17,21,2,0.000028
Wikipedia Review/Newyorkbrad just posted,,,3,0,3,2,0.000013
Durova,,,16,9,25,2,0.000043
Rodhullandemu,,,8,60,68,2,0.000015
Wikipedia is not censored,,,7,11,18,2,0.000013
Sebastopol,,,6,49,55,14,0.000026
Arcades,,,12,37,49,49,0.000016
Sega Genesis,,,22,44,66,49,0.000041
Nolan Bushnell,,,4,7,11,31,0.000013
Metal Slug,,,5,54,59,49,0.000015
Space Invaders,,,6,17,23,17,0.000015
Christian Bale,,,9,5,14,25,0.000021
ETD,,,12,45,57,2,0.000037
Kill screen,,,3,11,14,49,0.000011
Arceusfan2013,,,1,76,77,7,0.000011
Laddergoat,,,4,6,10,48,0.000014
Sonic News Network,,,8,25,33,2,0.000015
Little Big Planet,,,7,71,78,49,0.000013
Archaeology,,,1,93,94,37,0.000013
Maine,,,13,44,57,35,0.000028
Atlantis,,,22,46,68,37,0.00004
Vulva,,,8,2,10,36,0.000046
David Cameron,,,45,111,156,37,0.000055
Archive,,,4,8,12,9,0.000014
Ghettoditto,,,4,15,19,8,0.000019
Arctic Monkeys,,,11,48,59,12,0.000022
Gordon Brown,,,29,56,85,37,0.000041
Beastie Boys,,,18,77,95,63,0.00005
WEB SHERIFF,,,14,32,46,41,0.000017
Chavmo,,,7,18,25,12,0.000031
Arcturus,,,4,27,31,31,0.000016
Cbee,,,5,39,44,31,0.000012
Arcturus/email,,,1,2,3,64,0.000011
Ardi Rizal,,,1,10,11,46,0.000011
Toddlercon,,,31,20,51,28,0.000083
Poker Face,,,12,11,23,9,0.000035
Get into the Loop,,,4,27,31,48,0.000011
Beavis and Butt-head,,,20,82,102,34,0.000024
PCP,,,14,27,41,35,0.000034
Jerk,,,15,17,32,21,0.000029
MK ULTRA,,,11,29,40,17,0.000028
Russian Woodpecker,,,6,24,30,37,0.000016
Ares,,,1,66,67,8,0.000015
RTFM,,,37,6,43,10,0.000198
Wikipedia IRC Bouncers,,,20,37,57,2,0.000063
LJ killers,,,13,12,25,8,0.00006
Argent009/Transcript,,,1,3,4,41,0.000011
Argent009/Class Action Lawsuit,,,2,1,3,6,0.000011
The Mole,,,6,9,15,48,0.000019
Argent009/hissyfit,,,2,9,11,48,0.000014
Battim,,,14,132,146,48,0.00002
Argent Dawn (EU),,,4,93,97,51,0.000014
Darknest,,,5,90,95,33,0.000014
Me versus the World,,,4,8,12,41,0.000021
Argentina,,,56,243,299,35,0.000093
Lamer,,,23,9,32,8,0.000057
GNOME,,,11,28,39,10,0.000019
Hugo Chavez,,,27,53,80,14,0.000043
McDojo,,,8,65,73,13,0.000023
The Hand of Dios,,,15,29,44,35,0.000029
Bacon and eggs,,,12,35,47,52,0.000024
Bolivia,,,10,80,90,35,0.000034
Argentina is White,,,8,2,10,35,0.000025
Yahweh,,,31,13,44,46,0.000069
Bling bling,,,31,5,36,35,0.000039
Peru,,,18,28,46,35,0.000054
Chile,,,17,73,90,35,0.000028
Textile bomb,,,5,21,26,41,0.000018
"Mario ""Malevo"" Ferreyra",,,1,8,9,58,0.000011
PowerfulHorse,,,4,47,51,31,0.000012
Respect,,,13,127,140,17,0.000036
Christian Forums,,,4,66,70,46,0.000013
Aria Giovanni,,,6,23,29,39,0.000018
Aria Star,,,3,8,11,8,0.000012
Ladygaia87,,,3,22,25,8,0.000013
Josh Duggar,,,7,29,36,46,0.000015
WordPress,,,28,27,55,10,0.000101
Islamophobia,,,6,7,13,19,0.000019
Jeffree Star,,,41,80,121,12,0.000072
Larry,,,10,9,19,39,0.000021
Sheriff Joseph M. Arpaio,,,12,56,68,35,0.000023
Hole,,,11,2,13,35,0.000016
Dirty old man,,,1,0,1,35,0.000012
Golf,,,21,20,41,63,0.00003
Narcopolo,,,3,5,8,8,0.000012
Arkalochori,,,7,19,26,2,0.000015
Isarig,,,7,8,15,2,0.000019
Arkansas Sports Talk.net,,,2,86,88,0,0.000012
Faggot Icon,,,9,14,23,8,0.000018
Woopig.net,,,2,22,24,3,0.000011
Pansexual,,,17,38,55,0,0.000019
Bash,,,11,10,21,10,0.000024
Arkveveen,,,1,24,25,52,0.000011
Fat Acceptance Movement,,,38,46,84,52,0.000067
Hottie32,,,5,36,41,1,0.000019
Armada,,,3,2,5,41,0.000021
PC Gamer,,,18,67,85,49,0.000028
Armed Blowfish,,,3,11,14,2,0.000011
Yeti,,,14,16,30,11,0.000034
Kurdistan,,,15,63,78,37,0.000027
Nazi mysticism,,,17,40,57,46,0.000031
Sharon Lopatka,,,3,12,15,22,0.000014
XY,,,4,22,26,40,0.000012
Shoe0nHead,,,37,62,99,19,0.000061
Freethought Blogs,,,13,27,40,46,0.000019
Jenny McDermott,,,9,11,20,19,0.000018
Bearing,,,16,36,52,19,0.000026
Harmful Opinions,,,6,25,31,19,0.000014
Kraut and Tea,,,14,9,23,19,0.000027
LiveLeak,,,18,99,117,37,0.000032
Battlefield,,,36,7,43,49,0.000048
Collateral damage,,,4,9,13,37,0.000015
United States Marine Corps,,,5,17,22,13,0.000017
Colonel Russell Williams,,,3,18,21,17,0.000026
Dear Sir or Madam,,,1,3,4,27,0.000013
The-Lantiis,,,2,34,36,19,0.000013
Soldat,,,3,19,22,49,0.000013
Victor Pride,,,3,40,43,19,0.000016
Arohka,,,5,38,43,31,0.000013
Cownugget,,,2,11,13,31,0.000011
Arrow Cats,,,1,13,14,25,0.000019
Bubblegum Husky,,,6,29,35,31,0.000024
Arsewhole,,,3,12,15,39,0.000029
Modern Art,,,12,58,70,12,0.000078
Indiefucks,,,19,26,45,8,0.000029
Miller Test,,,13,27,40,53,0.000083
The Shower Project,,,4,2,6,39,0.000016
Face-painter,,,42,82,124,20,0.000149
Internet Art,,,3,8,11,0,0.000016
ArtGrounds,,,4,59,63,21,0.000012
Chode,,,25,42,67,63,0.000038
J/k,,,36,13,49,17,0.000082
Jhonen Vasquez,,,11,46,57,21,0.000025
Objection,,,13,3,16,9,0.000026
David Firth,,,10,9,19,12,0.000038
TinEye,,,4,21,25,6,0.000012
Epiphany,,,2,23,25,10,0.000012
Doll Bases,,,17,69,86,28,0.000024
Super Planet Dolan,,,19,82,101,53,0.000042
DrewTheFox,,,1,41,42,0,0.000011
Etsukoajibana,,,10,59,69,28,0.000017
Icon theft,,,25,21,46,8,0.000044
Smudge painting,,,3,12,15,21,0.000013
Incarnate,,,30,58,88,28,0.000112
Arthur,,,2,6,8,34,0.000013
Fonzie,,,16,1,17,34,0.000039
Arthur Kemp,,,3,30,33,37,0.000014
Arthur Tomaszewicz,,,1,6,7,21,0.000012
Evil-unveiled.com/Tom Arthur,,,9,2,11,43,0.00009
Port Arthur massacre,,,22,50,72,58,0.00003
Ian Miles Cheong,,,21,103,124,19,0.000021
Raid Backfire,,,24,16,40,19,0.000036
The Incredible Hulk,,,18,30,48,34,0.000036
Bandwagon,,,15,33,48,59,0.000027
Cards Against Humanity,,,7,104,111,19,0.000013
Suey Park,,,6,22,28,39,0.000013
Parody account,,,33,23,56,19,0.000047
Kung Fu Guy,,,9,21,30,19,0.000015
Joss Whedon,,,28,141,169,19,0.000033
Jonathan McIntosh,,,26,66,92,19,0.000052
Dumblr Feminist,,,8,99,107,19,0.000016
Nick Griffin,,,21,46,67,37,0.000049
Artica Sparkle,,,3,4,7,31,0.000011
Good article,,,9,35,44,2,0.00005
Artificial Intelligence,,,3,7,10,9,0.000014
Bucket,,,11,72,83,9,0.000019
Chatbot,,,5,5,10,9,0.000014
Artistic Games,,,1,9,10,49,0.000011
ArtsCow,,,3,7,10,9,0.000013
Artycat,,,5,2,7,9,0.000015
Party Cat,,,3,0,3,9,0.000024
Arudou Debito,,,4,20,24,28,0.000021
Aryanman,,,2,7,9,37,0.000013
Dynamic Entry,,,31,6,37,9,0.000074
Wrong Location Nigger,,,23,9,32,9,0.000038
ZEN,,,14,47,61,31,0.000059
Failcyclopedia,,,8,82,90,32,0.000091
Retsupurae,,,18,83,101,61,0.000021
Final Fantasy IV,,,9,98,107,49,0.000024
Rational Response Squad,,,35,143,178,46,0.000048
Mirror kisses,,,14,18,32,12,0.000037
Starwind3437,,,3,19,22,52,0.000012
Asalieri/Shows,,,2,32,34,61,0.000013
You Stupid Relativist,,,7,49,56,61,0.000017
Nazi Furs,,,30,43,73,31,0.000093
Mike Matei,,,7,55,62,61,0.000017
Darknessthecurse,,,9,135,144,24,0.000021
WMM,,,6,2,8,22,0.000012
Asalieri/Enemies,,,2,67,69,61,0.000013
Asalieri/Family,,,1,34,35,36,0.000012
Asalieri/Friends,,,3,37,40,61,0.000014
FanFic Critic,,,17,267,284,7,0.000038
XRazorfistx,,,11,80,91,61,0.000021
Vic Mignogna,,,12,45,57,28,0.000021
Ascii art,,,10,12,22,10,0.000027
Cowsay,,,4,6,10,10,0.000019
Penis-Nosed Fox,,,14,11,25,9,0.00003
Asdfmovie,,,1,17,18,4,0.000011
Metrosexual,,,33,30,63,40,0.000084
FCKH8,,,17,52,69,40,0.000032
Martha Stewart,,,5,27,32,39,0.000017
Fan death,,,4,22,26,11,0.000022
Cadmus,,,3,31,34,27,0.000014
Azuzephre,,,4,21,25,40,0.000012
Silvertree,,,5,12,17,39,0.000017
Emilie Autumn,,,19,91,110,12,0.000109
The Eunuch Archive,,,13,42,55,39,0.000022
Asheistheraven,,,4,98,102,19,0.000012
Steampunk,,,42,130,172,12,0.000087
Bum,,,29,9,38,39,0.000029
Brett Keane,,,47,63,110,46,0.000081
Fortune,,,18,14,32,9,0.000024
Lesbian invisibility,,,9,9,18,40,0.00003
Coughlan666,,,28,114,142,46,0.000048
Innocence of Muslims,,,8,151,159,37,0.000013
Asher2500,,,2,69,71,24,0.000011
Bakedfurs,,,7,10,17,31,0.000015
Bigger Man Argument,,,11,18,29,41,0.000014
Ashes Cricket 2013,,,2,10,12,49,0.000011
Cricket,,,6,66,72,37,0.000015
Blackwingdragon,,,15,64,79,0,0.000027
Ashida Kim,,,4,56,60,13,0.000014
Paladin-Press,,,7,16,23,4,0.000017
Bullshido.net,,,6,79,85,13,0.000015
Ashlea Clayton,,,2,4,6,36,0.000011
Transgender Day of Remembrance,,,8,15,23,63,0.000024
Ashley Madison,,,14,63,77,36,0.000044
Onidifag,,,1,0,1,36,0.000011
Tyra Banks,,,9,43,52,36,0.000016
Khizr Khan,,,3,3,6,19,0.000017
Pluto,,,7,32,39,1,0.000019
Vermin,,,22,12,34,52,0.000035
Michelle Malkin,,,23,82,105,14,0.000053
Piercing,,,10,25,35,40,0.00002
Mod Sass,,,12,41,53,24,0.000029
Ashleymariel,,,1,14,15,27,0.000011
Ashura,,,2,69,71,39,0.000013
FUCKING GAMESTOP!,,,16,17,33,49,0.000024
VideoGamePhenom,,,1,58,59,24,0.000011
Yaranaika,,,20,12,32,9,0.00003
Shibari,,,13,14,27,28,0.000069
Katamari Damacy,,,7,53,60,49,0.000017
Pikmin,,,13,62,75,49,0.000021
Lmao Zedong,,,28,43,71,37,0.00008
Pol Pot,,,18,15,33,37,0.000048
I LIEK MILK,,,10,2,12,50,0.000032
PAPER MARIO SCREENCAP,,,6,2,8,49,0.000018
Tamagotchi,,,11,70,81,44,0.000024
Where's Waldo?,,,15,15,30,37,0.000049
Kamikaze,,,14,6,20,41,0.000044
Myanmar,,,1,62,63,37,0.000013
Bleedman,,,32,97,129,21,0.000057
Edison Chen photo scandal,,,5,28,33,11,0.000028
Kato,,,7,28,35,28,0.000027
HOW CAN SHE SLAP?!?,,,25,39,64,48,0.000039
Tila Tequila,,,31,120,151,36,0.000065
Little Fatty,,,4,20,24,9,0.000014
Asianrevenge,,,1,6,7,35,0.000012
Asirra,,,1,2,3,9,0.000011
Ask.fm,,,1,23,24,13,0.000011
AskANinja.com,,,3,9,12,19,0.000015
Podcasting,,,24,15,39,19,0.000031
AskFMB,,,3,12,15,31,0.000012
AskTheTyrant,,,2,19,21,48,0.000013
Ozcult,,,10,30,40,11,0.000073
Avoiding Unwanted Attention,,,7,53,60,39,0.000037
High Functioning Autism,,,8,8,16,7,0.000022
Nicky Reilly,,,5,32,37,37,0.000021
Temple Grandin,,,3,2,5,7,0.00003
PUA,,,15,33,48,39,0.000031
Neurodiversity,,,9,33,42,7,0.000033
StumbleUpon,,,12,33,45,10,0.000035
Joey The Autist,,,2,23,25,7,0.000018
Sexual Harassment,,,20,34,54,39,0.000034
Pinkiepony,,,28,169,197,7,0.000045
ButLova,,,21,98,119,19,0.000067
ColonelDecon,,,1,3,4,0,0.000018
Conner Lupindo Hemming,,,14,99,113,31,0.000031
Flaglerchat,,,10,47,57,52,0.000025
Kingcobrajfs,,,1,2,3,48,0.000018
Joseph8276,,,9,30,39,52,0.000028
Jeffrey Hyde,,,2,14,16,30,0.000018
Matthew Davis,,,23,91,114,34,0.000055
Michael Gimson,,,2,125,127,13,0.000018
MylarBalloonFan,,,11,53,64,7,0.000027
Nihilistic Snake,,,12,40,52,32,0.000049
Omegalore,,,13,57,70,21,0.000033
Randomlaughingman,,,9,10,19,48,0.000034
ElectroRuffGiusep1,,,6,9,15,7,0.000035
Rockosocko,,,9,74,83,31,0.000031
The Eclectic Espeon,,,20,78,98,7,0.000048
Travis The Hipster,,,1,7,8,7,0.000018
Wesley!!!,,,4,29,33,38,0.000025
UltimateUKFFFan,,,7,34,41,28,0.00004
Hothead the mare,,,6,4,10,7,0.000044
Chris-chan/Asperchu,,,8,17,25,7,0.000024
Aspies for Freedom,,,6,69,75,24,0.00002
Autism macros,,,3,4,7,9,0.00002
Barron Trump,,,9,47,56,19,0.00003
Capital Gazette Shooting,,,5,31,36,58,0.000038
Charles Ziese,,,7,18,25,7,0.000024
FoolQuest.com,,,3,6,9,46,0.000024
Spergin,,,12,8,20,19,0.000023
Stoofoo.net,,,3,24,27,38,0.000021
Takedownman,,,16,71,87,0,0.000071
The Transit Coalition,,,5,10,15,7,0.000024
Ulillillia,,,16,52,68,7,0.000034
WAXLABLTABLER,,,7,35,42,6,0.000027
Asperger's syndrome/Open Letter,,,0,1,1,55,0.000011
Asphyxiaphilia,,,1,16,17,39,0.000012
Asphyxiation,,,3,31,34,31,0.000012
Hutchence's Syndrome,,,9,7,16,39,0.000018
SapphyDracases,,,31,118,149,28,0.000116
Kay Fedewa,,,14,52,66,24,0.000026
WisCon,,,11,67,78,52,0.000041
Cotton Ceiling,,,16,36,52,19,0.000058
Fat furry,,,38,100,138,31,0.000047
List of Proposed Internet-Based IRL Communities,,,5,26,31,46,0.000022
Cigarskunk,,,17,102,119,31,0.000077
Braaaap,,,4,31,35,19,0.000056
Felching,,,29,9,38,15,0.000079
Ass Vegan,,,3,37,40,3,0.000013
Swenglish,,,4,39,43,3,0.000011
Snuff porn,,,1,0,1,3,0.000011
Kang,,,1,4,5,3,0.000011
Assassin's Creed,,,23,157,180,49,0.000041
Sup,,,7,17,24,9,0.000019
Life hacks,,,19,12,31,37,0.00003
Deus Ex,,,24,110,134,17,0.000034
Sammich,,,92,32,124,39,0.000184
Wolverine,,,23,48,71,34,0.000028
Grand Theft Auto IV,,,7,71,78,35,0.000018
Call of Duty: Black Ops,,,11,144,155,40,0.000024
Britchan,,,57,45,102,37,0.000095
Uncharted,,,9,29,38,49,0.000016
Shout out,,,3,23,26,46,0.000076
Assembly,,,4,16,20,10,0.000016
Billy the Heretic,,,9,15,24,19,0.000031
Robotnik,,,69,89,158,63,0.00014
Racial Profiling,,,8,33,41,35,0.000024
ToKeN,,,13,12,25,10,0.000024
Poe's Law,,,15,37,52,46,0.000025
Patriarchy,,,63,23,86,39,0.000072
Manic Pixie Nightmare Girls,,,3,65,68,19,0.000011
Lizzy the Lezzy,,,8,23,31,7,0.000017
Leoian,,,5,35,40,31,0.000012
Asslink,,,4,10,14,39,0.000012
Bill Joy,,,3,16,19,10,0.000013
Figging,,,10,12,22,39,0.000042
Vital article,,,3,51,54,2,0.000012
Astablazia,,,6,41,47,48,0.000024
Denalynnn,,,5,29,34,48,0.000016
Nornna,,,4,14,18,48,0.000012
Astarcis,,,0,3,3,37,0.000011
Astrima,,,6,65,71,21,0.000013
Suethor,,,24,31,55,21,0.00004
Astrolldancer,,,2,2,4,8,0.000015
AtJap13,,,2,57,59,28,0.000019
Hungary,,,31,44,75,37,0.000107
Ganguro,,,12,26,38,28,0.000023
Delicate flower,,,1,0,1,28,0.000011
Koreaboo,,,13,41,54,40,0.000034
AtWar,,,5,73,78,37,0.000016
Church of Zizou,,,2,10,12,0,0.000011
Gossip Girl,,,3,90,93,36,0.000018
Justice League Unlimited,,,9,18,27,31,0.000019
"At first I was like X, but then I was like Y",,,3,41,44,9,0.000011
User Stress Syndrome,,,6,18,24,2,0.000014
X FUCKING Y,,,4,8,12,9,0.000012
Custer's Revenge,,,12,33,45,49,0.000017
Bulletball,,,21,21,42,32,0.000037
Delete,,,38,17,55,8,0.000036
Curio,,,7,4,11,41,0.000014
Superman 64,,,17,14,31,49,0.00003
Ate my balls,,,8,15,23,10,0.000036
Ateaseweb,,,2,50,52,7,0.000011
Roflcoptor,,,1,0,1,7,0.000011
Alias,,,1,0,1,7,0.000011
Thom Yorke and Cheesecake,,,3,26,29,21,0.000011
Atheism+,,,0,47,47,46,0.000011
Richard Carrier,,,5,22,27,46,0.000012
FakeSagan,,,26,142,168,46,0.000042
Karl Popper,,,3,18,21,46,0.000016
Schrödinger's cat,,,17,50,67,25,0.000034
I am silly!,,,13,42,55,46,0.000047
Cop-out,,,9,34,43,46,0.000044
The Arguecat Weightloss Challenge,,,24,18,42,52,0.000041
William Lane Craig,,,3,18,21,46,0.000015
Stephen Fry,,,15,117,132,17,0.000038
George Carlin,,,34,69,103,46,0.000075
DotA 2,,,8,70,78,49,0.00002
Rebecca Watson,,,23,34,57,39,0.000053
MMA,,,10,23,33,35,0.000018
Seanbaby,,,12,34,46,61,0.000022
The Law of Conformity,,,9,10,19,12,0.000029
Read a book,,,18,61,79,46,0.000056
CultOfDusty,,,3,5,8,7,0.000015
Poe,,,1,2,3,46,0.000013
David Sherratt,,,6,48,54,19,0.000019
The Cold War,,,22,68,90,37,0.000036
New York City Atheists,,,2,23,25,46,0.000022
The Half Hour News Hour,,,2,17,19,14,0.000019
French Revolution,,,2,5,7,37,0.000014
Julia Gillard,,,9,24,33,14,0.000027
Björk,,,13,41,54,10,0.000032
Salman Rushdie,,,8,11,19,37,0.000022
IIDB,,,3,3,6,58,0.000013
Proof That God Exists,,,5,8,13,46,0.000019
The Easter Bunny,,,7,38,45,46,0.000026
Atheist Scum United,,,5,11,16,46,0.000017
OneLessGod,,,6,17,23,46,0.000018
Trolling organization,,,14,41,55,41,0.000084
Athene,,,3,42,45,26,0.000014
Twitch,,,35,34,69,19,0.000029
Good Person Test,,,12,18,30,46,0.00002
Tommy Sotomayor,,,4,11,15,35,0.000012
Zezima,,,7,43,50,49,0.000027
Your argument is invalid,,,18,10,28,46,0.000052
Flower,,,7,22,29,25,0.000017
Dolphy,,,14,80,94,21,0.000016
EFN,,,1,5,6,35,0.000012
Onefiftytwo,,,2,0,2,35,0.000014
Chocolate,,,22,20,42,34,0.000039
Xtex,,,4,4,8,8,0.000013
Mikenatlga,,,1,0,1,35,0.000012
Atlantic Records,,,7,5,12,12,0.000014
The Bahamas,,,3,25,28,35,0.000012
The Sims,,,31,87,118,8,0.000054
Creation,,,4,20,24,46,0.000021
Wizards,,,1,0,1,37,0.000011
Bread,,,17,7,24,9,0.000031
Comic Sans,,,19,139,158,10,0.000043
Nayzak,,,8,49,57,37,0.000031
BTFO,,,22,8,30,19,0.000024
Internet Jihadist,,,3,12,15,37,0.000018
Atlus,,,15,72,87,49,0.00002
Hatefag,,,7,79,86,26,0.000022
Mecha-Dildo,,,14,12,26,39,0.000048
Big Dog,,,14,11,25,9,0.000033
Demon's Souls,,,7,44,51,49,0.000018
Atm,,,2,7,9,17,0.000011
Wikitruth,,,22,25,47,2,0.000042
Wiki Abuse,,,7,56,63,2,0.000018
The Daily Show,,,50,86,136,14,0.000084
World's Ugliest Dog,,,9,21,30,6,0.00004
Epic Nose Guy,,,11,36,47,26,0.000018
Sherlock,,,21,73,94,33,0.000052
Attackofthehank,,,2,22,24,34,0.000012
Attendance Bot,,,3,19,22,9,0.000011
Girlmecha,,,12,39,51,8,0.00005
TammyToe,,,8,37,45,36,0.000031
Train Of Thought,,,1,2,3,8,0.000023
Histrionic Personality Disorder,,,40,19,59,8,0.000126
Misanthropik,,,1,7,8,53,0.000028
Msscribe,,,11,115,126,52,0.000039
T.A.T.u.,,,17,51,68,36,0.000042
Ella Freya,,,1,13,14,17,0.000028
Kaitlyn Hunt,,,2,20,22,42,0.000028
Leah Remini,,,18,88,106,26,0.000065
Patrick Hamm and Lena Chen,,,35,87,122,37,0.000215
Liz Hawryluk,,,6,14,20,39,0.000034
Cocaine Babe,,,7,18,25,36,0.000075
Michael Arega,,,7,31,38,35,0.000052
Sinn0h,,,1,21,22,13,0.000028
Tina S.,,,15,32,47,37,0.000095
Feltcho voicemails,,,7,13,20,41,0.000019
MIA Encyclopedia Dramaticians,,,27,50,77,44,0.000069
Ray Gordon,,,4,23,27,24,0.000022
User:JesuitX,,,15,0,15,41,0.000083
FreeSaiyan,,,9,41,50,28,0.000041
Charles Carreon,,,6,54,60,54,0.000017
Audible.com,,,2,7,9,6,0.000011
ITunes,,,34,63,97,10,0.000045
Audio,,,5,7,12,9,0.000012
AudioLJ,,,2,4,6,8,0.000012
Futhman,,,19,9,28,8,0.000075
Audio sorcerer,,,2,6,8,27,0.000012
Audiophile,,,18,22,40,12,0.000038
MP3,,,33,12,45,12,0.000042
FLAC,,,7,66,73,12,0.000021
SHAKTI Stone,,,1,11,12,37,0.000012
Vinyl,,,7,7,14,12,0.000017
The Kewl Kids,,,23,35,58,48,0.000025
Trevor Rieger,,,4,33,37,48,0.000012
YTwatchdog,,,8,62,70,48,0.000014
August Ames,,,3,60,63,19,0.000011
Bearforce1,,,6,16,22,40,0.000014
Jessica Leeds,,,8,156,164,19,0.000014
MyFreeImplants,,,37,54,91,36,0.000087
Discrimination,,,21,35,56,35,0.000032
August Ragone,,,1,14,15,52,0.000013
Gamera,,,3,1,4,52,0.000012
RoboCop,,,6,12,18,34,0.000013
August Underground's Mordum,,,10,38,48,22,0.000036
Cloverfield,,,22,43,65,29,0.000033
Cannibal Holocaust,,,13,83,96,22,0.000033
Paraphilia,,,27,81,108,39,0.000052
Furry News Network,,,9,28,37,31,0.000016
ThunderRoo,,,2,16,18,31,0.000011
Guess The Meme,,,11,42,53,9,0.000029
Augusto Pinochet,,,12,24,36,37,0.000027
ImageBoard4Free,,,6,46,52,9,0.000014
IP ban,,,7,16,23,24,0.000015
Lemonade Coyote,,,11,15,26,31,0.000017
Online Roleplaying,,,11,100,111,21,0.00002
Gay Rape,,,15,75,90,39,0.000133
The Batman Rapist,,,11,62,73,39,0.000029
Dangerman,,,9,27,36,35,0.000055
Aush0k,,,16,32,48,10,0.000067
Garrett,,,9,0,9,41,0.000022
Austerity,,,3,17,20,14,0.000012
John Boehner,,,6,17,23,14,0.00003
Fag Enabler,,,36,28,64,40,0.000119
No More Heroes,,,7,60,67,49,0.000015
Dell,,,12,23,35,10,0.000029
Homosexual epithets,,,13,27,40,40,0.000042
Wook,,,8,32,40,14,0.000016
BlogTalkRadio,,,13,8,21,56,0.000017
Oklahoma,,,14,11,25,35,0.000017
"Fort Worth, TX",,,4,36,40,35,0.000036
Operation SyPhyllis,,,9,116,125,26,0.000018
Austin Fullmer,,,1,15,16,26,0.000011
Rock,,,31,60,91,12,0.000048
Austnet,,,2,8,10,41,0.000011
Austral-Azn,,,4,38,42,21,0.000012
Urd-chan,,,6,55,61,21,0.000018
Dancing-In-Fire,,,3,29,32,21,0.000012
Trinity Bates,,,5,47,52,39,0.000013
Conti,,,18,41,59,31,0.000048
Bavaria,,,2,12,14,37,0.000016
Dr. Date Rape,,,14,66,80,39,0.000023
The New York Times,,,25,18,43,19,0.000087
Viennese vernacular,,,1,23,24,37,0.000011
Jew Hat,,,7,32,39,17,0.000017
Yiffstar,,,13,72,85,31,0.000052
In-Jokes,,,8,11,19,2,0.000039
Pirate Party of Austria,,,1,29,30,37,0.000011
Authonomy,,,6,98,104,59,0.000012
Twitard,,,25,144,169,32,0.00006
Holy Grail,,,16,13,29,26,0.000018
Reptoid,,,51,42,93,17,0.000137
Autistic Legion of Doom,,,7,15,22,7,0.000021
Vordrak,,,17,52,69,19,0.000025
Oliver D. Smith,,,16,63,79,19,0.000032
Tommy Tooter,,,5,4,9,19,0.000015
YandereDev,,,14,100,114,13,0.000021
Donny Long,,,2,81,83,51,0.000012
Mikemikev,,,11,94,105,2,0.000019
Curt Sibling,,,7,26,33,7,0.000028
Jonathan Bishop,,,2,3,5,19,0.000012
Brian Adams,,,2,8,10,0,0.000013
AutoAdmit,,,19,56,75,11,0.00004
Myah Walker,,,18,50,68,46,0.00003
Miriam Weeks,,,12,31,43,36,0.000046
CollegiateACB,,,6,7,13,11,0.000015
Gossip Report,,,6,3,9,2,0.000023
IvyGate,,,6,8,14,11,0.000018
JuicyCampus,,,7,41,48,11,0.00002
Autobbq,,,3,4,7,9,0.000014
Autobiography of an Invisible Monster,,,1,33,34,40,0.000011
Automattic,,,3,5,8,2,0.000024
Autoplay,,,8,45,53,48,0.000021
Double redirect,,,6,0,6,2,0.000032
Category:Music,,,9,0,9,12,0.000021
Mescaline,,,12,32,44,35,0.000033
DMT,,,12,29,41,13,0.00003
Keith Boadwee,,,8,18,26,6,0.000051
Vagina Bike,,,8,11,19,39,0.000022
AvantGardePony,,,14,39,53,19,0.000018
Avast,,,5,14,19,10,0.000023
Avira,,,7,23,30,10,0.000028
Bacteria,,,5,23,28,37,0.000018
Icon,,,42,19,61,8,0.000112
James Cameron,,,4,19,23,46,0.000016
Avatar Gay Drama,,,7,36,43,0,0.000016
The Legend of Korra,,,16,173,189,34,0.000046
Pregnophile,,,21,54,75,39,0.000054
THAN HOW DID AVATAR DO IT?,,,3,24,27,33,0.000011
M. Night Shyamalan,,,4,8,12,42,0.000012
Bill Waggoner Crew,,,7,22,29,56,0.000015
Cameltoe,,,13,16,29,36,0.000052
YouNow,,,4,157,161,17,0.000015
Whitney Wisconsin,,,10,70,80,36,0.000035
Conficker,,,4,28,32,10,0.00002
Avoidance,,,1,6,7,2,0.000013
Tide Pods,,,3,11,14,19,0.000014
Depression Quest Simulator,,,5,3,8,19,0.000014
Einshine,,,5,69,74,13,0.000014
Sucky sucky 5 dollar,,,1,0,1,2,0.000012
Reference Desk,,,3,69,72,2,0.000012
First post,,,23,21,44,8,0.000055
Quake,,,29,100,129,49,0.000043
Bill Kaulitz,,,24,62,86,12,0.000054
Makhan,,,5,32,37,21,0.000028
Hypnocake,,,8,13,21,9,0.000036
EarthBound,,,30,162,192,49,0.000042
Deep thinker,,,42,25,67,2,0.000053
Jissouseki,,,14,54,68,22,0.000027
Ultros,,,7,12,19,9,0.000017
Code Geass,,,24,216,240,28,0.000044
Nannerpus,,,5,10,15,9,0.000019
Steve Wilkos,,,11,78,89,53,0.00004
Untitled.jpg,,,2,5,7,6,0.000054
Awesome Cougars,,,3,18,21,12,0.000016
DJ,,,17,35,52,12,0.000025
AwkwardFamilyPhotos.com,,,2,14,16,31,0.000012
Axelswife1,,,5,16,21,48,0.000013
Axila,,,8,103,111,0,0.000012
Axl Darkix,,,5,26,31,12,0.000012
Kawaii Kitsune,,,6,32,38,52,0.000013
Tails Doll,,,27,51,78,7,0.000046
Aydin Paladin,,,4,121,125,19,0.000012
Celtic,,,14,4,18,37,0.000022
Ben Shapiro,,,5,10,15,19,0.000014
MGTOW,,,16,38,54,19,0.00003
GamerGate/POTM,,,9,83,92,19,0.000016
Kevin Logan,,,1,2,3,19,0.000011
Murdoch Murdoch,,,2,70,72,19,0.000011
Jonathan Ross,,,1,12,13,7,0.000011
Devon Tracey,,,6,45,51,19,0.000032
Shortcat,,,22,10,32,25,0.00004
Water boarding,,,1,0,1,14,0.000011
Rush,,,8,5,13,12,0.000017
Starblade,,,17,48,65,31,0.000039
Starecat,,,9,45,54,9,0.00003
Ayuka Narita,,,0,18,18,11,0.000011
Ayumihamilton,,,3,69,72,28,0.000011
Hellsingripvanwinkle,,,5,34,39,28,0.000014
Aywas,,,8,117,125,38,0.000013
Complaints Forum,,,24,116,140,21,0.000072
Wajas,,,14,66,80,31,0.000014
Work safe,,,28,36,64,2,0.000059
Azad slide,,,6,12,18,8,0.00003
Lima pcp,,,2,17,19,8,0.000014
Doc neuro,,,5,25,30,8,0.000023
Scrolling marquee,,,1,0,1,8,0.000013
LJ-cut,,,12,17,29,8,0.000033
Azer Red,,,3,17,20,2,0.000016
Cyde,,,19,117,136,2,0.000031
Azeus,,,3,8,11,12,0.000012
D. Omen,,,2,9,11,12,0.000012
Liart66,,,12,54,66,27,0.000041
Oompa Loompas,,,22,52,74,36,0.000039
Xanga,,,20,27,47,8,0.000053
RiceGum,,,7,22,29,17,0.000021
Riboflavin,,,10,18,28,48,0.000034
Rockonlittleone,,,10,21,31,8,0.000027
Dog-shit-girl,,,3,23,26,39,0.000025
Darktrap,,,5,29,34,28,0.000034
Nick Chaleunphone,,,8,95,103,48,0.000024
Darkspeeds,,,4,7,11,21,0.000019
Xiao Rishu,,,10,60,70,63,0.000028
Mizhi County No. 3 Middle School Attack,,,5,29,34,58,0.000026
Single Asian Female,,,6,26,32,11,0.000027
Domo-kun,,,9,46,55,28,0.000053
Sk8ter,,,5,24,29,3,0.000022
Azrael2002,,,1,19,20,8,0.000011
Raksha,,,2,14,16,41,0.000012
Nichijou,,,7,100,107,28,0.000019
K-On!,,,17,107,124,28,0.000024
Daniel Benfield,,,4,89,93,41,0.000012
Azureus,,,3,11,14,10,0.000013
Private tracker,,,7,32,39,10,0.000015
B*KewT,,,3,24,27,28,0.000011
Bean,,,20,74,94,38,0.000054
Ogrish.com,,,20,10,30,6,0.000046
Edward Nygma,,,1,16,17,9,0.000022
"You Laugh, You Lose",,,22,41,63,9,0.000049
DAS TROLLPARADIES,,,4,112,116,9,0.000022
Dubstep,,,30,17,47,12,0.000045
GET/Post 200M,,,2,3,5,9,0.000024
Dramaking,,,2,8,10,9,0.000022
Kitten Bagger,,,1,8,9,17,0.000022
Klik-BOMF,,,3,11,14,9,0.000022
Lano Ungen,,,3,23,26,53,0.000024
Mike Buchan,,,2,6,8,26,0.000023
Mr. Goodlife,,,3,6,9,9,0.000024
MuchoZucko,,,9,89,98,6,0.000049
Wikichan,,,23,28,51,9,0.000053
The Caturday Revival,,,13,76,89,9,0.00003
B/-day 2,,,2,12,14,9,0.000012
Metawire,,,3,18,21,10,0.000012
B/space Day,,,6,26,32,6,0.000017
Phish,,,13,8,21,21,0.000026
BayHorseCrew,,,21,35,56,41,0.00004
Operation Blue Crayon,,,3,13,16,26,0.000018
Wowzaz 86,,,5,36,41,8,0.000044
B0G,,,3,46,49,8,0.000013
Nymphetamine,,,1,12,13,8,0.000011
Sweet Eva,,,21,67,88,26,0.00004
B0rk,,,10,11,21,10,0.000024
B2K,,,2,19,21,39,0.000012
B3ta,,,8,16,24,9,0.000023
B4b0,,,3,11,14,41,0.000014
H0no,,,1,0,1,41,0.000012
"BABY, THE STARS SHINE BRIGHT",,,3,24,27,28,0.000012
Sankaku Complex,,,16,37,53,28,0.00004
Bad Jokes and Other Deleted Nonsense,,,7,19,26,2,0.000015
Onomatopoeia,,,2,2,4,6,0.000012
The Comprehensive Theory of Lulz,,,23,127,150,1,0.000079
BANGS,,,3,27,30,10,0.000015
Sudan,,,22,53,75,37,0.000042
BASH,,,0,7,7,10,0.000011
Shell,,,6,22,28,10,0.000017
Wpcomment.sh,,,5,5,10,10,0.000021
The Secret Show,,,2,7,9,34,0.000012
Tommy Davis,,,12,52,64,26,0.00002
Shamefur Dispray,,,7,5,12,17,0.000019
Elitist Musical Bastards,,,20,125,145,12,0.00005
Cyril Smith,,,10,16,26,17,0.000046
Subliminal Messages,,,12,16,28,27,0.00003
Operation Yewtree,,,15,59,74,17,0.000019
Operation Fairbridge,,,9,31,40,17,0.000018
Fur faggotry,,,1,0,1,17,0.000012
BBC Radio 4,,,3,32,35,15,0.000012
British CSA Inquiry,,,3,58,61,27,0.000013
George Osborne,,,12,54,66,37,0.000018
Mornington Crescent,,,4,20,24,15,0.000017
Have I Got News For You,,,7,46,53,14,0.000016
BBQ Becky,,,1,19,20,19,0.000014
Privilege,,,35,6,41,19,0.000037
The God Warrior,,,9,27,36,38,0.000062
Permit Patty,,,5,18,23,35,0.000068
LORD,,,4,8,12,49,0.000025
BBW Porn Sites,,,7,68,75,52,0.000038
Fat Admirer,,,24,44,68,52,0.000069
Flat Chan,,,10,46,56,52,0.000022
Pear Chan,,,15,37,52,52,0.000058
Dailymotion,,,7,15,22,48,0.00002
RedTube,,,18,33,51,40,0.00004
BCO,,,3,17,20,8,0.000018
Metapod,,,9,11,20,9,0.000013
BDIC,,,2,20,22,17,0.000013
BDIC/GNWT,,,2,4,6,17,0.000011
Guatemala,,,6,0,6,35,0.000015
Safeword,,,11,10,21,39,0.000048
Vacuum Bed,,,2,5,7,39,0.000021
Gloriousmandestroya,,,2,49,51,32,0.00003
Wipipedia,,,6,65,71,2,0.000023
BECAUSE MY CAPS LOCK KEY IS LOUD,,,8,17,25,12,0.000034
Hissy Fit,,,17,1,18,8,0.000035
BGCLive,,,1,20,21,40,0.000011
RealJock,,,6,107,113,40,0.000012
BG Kumbi,,,0,8,8,38,0.000011
BIKECAT,,,16,46,62,9,0.00006
Kevin Neil Whitrick,,,13,10,23,1,0.000043
Fishing Cat,,,17,26,43,25,0.000047
Blu,,,6,3,9,43,0.000041
Font size=5,,,20,6,26,10,0.000094
Word,,,19,9,28,10,0.000027
Dream Theater,,,9,57,66,12,0.000027
Cillit Bang,,,9,22,31,9,0.000019
Pedofox,,,9,33,42,9,0.000026
BLACKB0ND,,,13,75,88,19,0.000018
Chess.com,,,3,27,30,16,0.000012
BLACKbusterCritic,,,30,94,124,7,0.000067
ReviewTechUSA,,,5,24,29,19,0.000012
BLACKED,,,4,1,5,19,0.000011
BLACKFOOT,,,1,25,26,19,0.000011
Troll Kingdom,,,7,27,34,41,0.000015
Rucas,,,9,20,29,41,0.000023
User:ASeriesofTubes,,,1,0,1,41,0.000014
Philip Markoff,,,8,25,33,41,0.000019
BioWare,,,6,13,19,19,0.000018
KingMasterReview,,,10,18,28,7,0.000015
Niggerdick,,,13,41,54,41,0.000043
SolidMario,,,7,34,41,7,0.000014
Console Wars,,,15,70,85,49,0.000022
Blank Article,,,3,0,3,2,0.000017
Vandal/How-to,,,16,36,52,2,0.000054
BLARGH IS NOW A MEME,,,10,22,32,41,0.000041
^,,,6,13,19,41,0.000014
Mobying,,,2,11,13,14,0.000013
Transhumanism,,,9,15,24,46,0.000017
Women's Space,,,3,13,16,26,0.000012
Jerelyn Luther,,,1,16,17,39,0.000011
Bonita Tindle,,,3,6,9,19,0.000013
Sarah Andersen,,,16,149,165,19,0.000029
John Seigenthaler Sr.,,,8,15,23,2,0.000025
Deletionist,,,20,29,49,2,0.000018
Death List,,,10,74,84,2,0.000042
Einsidler,,,9,1,10,48,0.000033
Redirect,,,4,7,11,2,0.000013
Pounced.org,,,6,29,35,31,0.000013
Windows Live Spaces,,,3,20,23,10,0.000017
Thedreadedkettle,,,12,14,26,10,0.000022
Tramp stamp,,,14,10,24,36,0.000052
Dianne Thorley,,,18,49,67,42,0.000078
Banbot,,,8,9,17,41,0.00004
BNF,,,8,24,32,8,0.000023
BOOBIES!!,,,0,23,23,8,0.000011
Jassa,,,2,9,11,8,0.000011
BPL,,,4,5,9,10,0.000025
Regfuq,,,1,3,4,10,0.000015
Drunken boxer,,,1,4,5,10,0.000015
Matthew Sammon,,,3,6,9,53,0.000029
BREADCRAB,,,7,26,33,25,0.000014
Giant Isopod,,,10,23,33,25,0.000018
Octocat,,,12,44,56,9,0.000028
Jesus Tortilla,,,13,43,56,46,0.000033
BSD License,,,2,3,5,10,0.000013
Insub,,,13,14,27,41,0.000091
Darren Reed,,,3,9,12,10,0.000015
Zb,,,10,23,33,41,0.000034
Braille,,,26,16,42,18,0.000033
Browser,,,18,8,26,10,0.000038
Theo de Raadt,,,12,16,28,10,0.000022
GPL,,,16,18,34,10,0.000032
BSDcode,,,1,6,7,41,0.000012
BURK,,,5,10,15,48,0.000013
YouTube Yahweh Clan,,,26,86,112,48,0.000028
Damaron,,,8,34,42,31,0.000018
Hawaiian Dicking,,,36,12,48,39,0.000111
Baaa,,,3,4,7,48,0.000013
Babalon,,,2,2,4,6,0.000012
The Heirophant Council,,,4,10,14,16,0.00002
Babel:Ja/外人の目で見る日本,,,0,33,33,28,0.000011
GaijinSmash,,,4,22,26,28,0.000012
MegaTokyo,,,37,66,103,28,0.000051
Babel:Japanesu/Japan,,,0,42,42,28,0.000011
No pictures plz,,,2,15,17,6,0.000018
"Jimbo's Japan Tour, 2007",,,3,12,15,2,0.000021
BabelFish,,,10,19,29,37,0.000018
Babies for breakfast babies for dinner,,,4,1,5,1,0.000017
Interior Crocodile Alligator,,,22,37,59,9,0.000057
Church of Euthanasia,,,5,19,24,46,0.000016
Nouglybabies,,,16,14,30,8,0.000047
Pregnant Loli,,,35,48,83,36,0.000073
Hugh Jidette,,,7,11,18,37,0.000061
McFnord,,,7,20,27,8,0.000019
Dancing Baby,,,12,20,32,9,0.000029
Retarded Animal Babies,,,8,47,55,34,0.000052
Shave the baby,,,8,8,16,37,0.000025
Cuckservative,,,20,7,27,19,0.000022
Ian Watkins,,,14,102,116,12,0.000032
Baby Grace,,,8,45,53,1,0.000017
Ethical Hacker,,,8,16,24,10,0.000022
Owlsamantha,,,7,11,18,1,0.000029
WHARRGARBL,,,11,1,12,1,0.00002
Pruno,,,8,33,41,39,0.000023
Baby Jesus,,,6,29,35,46,0.000015
"Georgia, USA",,,13,59,72,35,0.000021
Necrofurs,,,21,23,44,31,0.000061
Padded Ponies,,,4,37,41,7,0.000023
Bastnfalkr,,,2,23,25,31,0.000013
Coti,,,2,11,13,31,0.000013
Crinklemon,,,15,71,86,7,0.000024
Crinklepedia,,,3,12,15,31,0.000016
Joe Crusher Pickles,,,10,53,63,34,0.00002
Luca Shoal,,,5,20,25,31,0.000015
Simba Wion,,,3,12,15,31,0.000014
TheWetRabbit,,,20,58,78,31,0.000038
Zareth,,,6,35,41,31,0.000023
FuckU-FuckMe,,,6,9,15,10,0.00002
Back to the Future,,,2,8,10,34,0.000011
Backmasking,,,7,21,28,12,0.000021
Beyoncé Knowles,,,12,15,27,35,0.000019
Backstroke of the West,,,3,27,30,56,0.000031
Big,,,13,11,24,10,0.000041
Wookieepedia,,,15,70,85,2,0.00003
Robot in a suit,,,5,9,14,9,0.000014
Borscht,,,8,17,25,9,0.000015
Epic Meal Time,,,9,13,22,37,0.000031
Las Pegasus Unicon,,,5,41,46,7,0.000014
Donald Buffkin,,,10,72,82,7,0.000021
John Travolta,,,24,35,59,26,0.000038
Bad Apple,,,1,7,8,12,0.000011
Bad Article,,,12,3,15,2,0.000018
Coooooooooooooooooooo,,,1,0,1,2,0.000016
Exhibit A,,,10,7,17,2,0.000022
Fursecution Fox,,,15,17,32,31,0.000027
Zetaforum,,,14,10,24,31,0.000052
Horsecock,,,16,10,26,31,0.000042
Bad Mothers,,,4,4,8,9,0.000018
Whatchild,,,2,3,5,9,0.000023
Narnia,,,7,35,42,5,0.000015
GuysWithIPhones.com,,,8,18,26,10,0.000017
"Упячка",,,6,26,32,37,0.00002
Bad Webcomics Wiki,,,4,85,89,31,0.000012
CrushYiffDestroy,,,20,50,70,31,0.000022
God Awful Fan Fiction,,,10,31,41,36,0.000021
Night Auditor,,,1,0,1,31,0.000011
Vivienne Medrano,,,1,24,25,31,0.000011
Burned Fur,,,12,9,21,31,0.000021
Neo-Kosmos,,,3,26,29,15,0.000011
Suirenoki,,,6,57,63,21,0.000013
Exterminatus Now,,,5,39,44,31,0.000011
Kevin & Kell,,,12,70,82,31,0.000023
Jennifer Diane Reitz,,,19,65,84,26,0.000043
Psyguy,,,10,47,57,7,0.000017
Tim Todd,,,8,30,38,46,0.000024
David Gonterman,,,26,106,132,28,0.000043
Humon,,,6,32,38,37,0.000013
LOOK WHAT I BROUGHT HOME,,,4,22,26,40,0.000012
HamletMachine,,,7,162,169,30,0.00002
Immelmann,,,6,32,38,57,0.000012
James M. Hardiman,,,7,24,31,31,0.000025
D. C. Simpson,,,12,79,91,31,0.000024
Comic Genesis,,,7,32,39,40,0.000014
TwoKinds,,,5,102,107,49,0.000012
Moon Over June,,,3,21,24,28,0.000012
The Nice Guy Comic,,,3,14,17,36,0.000011
God Mode,,,18,18,36,1,0.000026
Sore Thumbs,,,5,30,35,14,0.000013
Hathor the Cow Goddess,,,10,81,91,14,0.00003
Questionable Content,,,18,102,120,15,0.000042
Bengo,,,3,26,29,15,0.000011
MAD magazine,,,11,77,88,34,0.00002
Badfic,,,5,21,26,61,0.000015
Badger,,,0,11,11,44,0.000011
Honey Badger,,,9,10,19,44,0.000015
Hufflepuff,,,6,78,84,44,0.000018
BagToon,,,0,19,19,34,0.000011
Frozen,,,24,4,28,34,0.000044
Bagman,,,1,1,2,8,0.000014
Bags of Money,,,1,6,7,53,0.000011
Evil-unveiled.com/Boylandonline.com,,,42,11,53,43,0.000196
Oppression Olympics,,,15,23,38,19,0.000044
Brian Hall,,,4,13,17,19,0.000021
Gallium,,,7,13,20,37,0.000033
Five Year Plan,,,3,105,108,13,0.000029
Jonathan Kendrick Lewis,,,7,35,42,34,0.000015
Banks,,,1,0,1,17,0.000012
Poker,,,7,36,43,3,0.000032
Gremlins,,,1,0,1,17,0.000012
Bain,,,0,7,7,17,0.000011
Payday 2,,,4,85,89,17,0.000014
Baka,,,7,11,18,28,0.000033
Cirno,,,5,88,93,28,0.000014
BakaRed,,,5,77,82,46,0.000027
Carl Sagan,,,28,37,65,46,0.000061
Shinra Online,,,10,59,69,50,0.000044
Story,,,1,0,1,46,0.000011
Kick the Freak,,,4,14,18,8,0.000014
Computer science,,,20,10,30,10,0.000029
Baked Alaska,,,3,9,12,19,0.000011
BuzzFeed,,,52,90,142,19,0.000059
Bakugan,,,2,77,79,28,0.000011
Queef,,,25,42,67,39,0.000033
Exhibit C,,,29,11,40,2,0.000044
Siamese twin,,,1,0,1,28,0.000011
Lucky Coyote,,,6,59,65,31,0.000029
Balddumborat,,,7,97,104,7,0.000028
Hir,,,14,24,38,31,0.000047
Lil Miss Jay,,,2,39,41,31,0.000011
Beaver,,,11,4,15,26,0.000035
GodofUnicorns,,,5,157,162,27,0.000013
Baldi's Basics,,,1,56,57,7,0.000011
Doki Doki Literature Club,,,10,61,71,13,0.000026
Markiplier,,,19,18,37,7,0.000018
JackSepticeye,,,8,17,25,7,0.000014
Ugandan Knuckles,,,12,31,43,19,0.000019
Bethesda Softworks,,,18,24,42,49,0.000017
Phineas and Ferb,,,15,66,81,34,0.000022
Bale,,,2,3,5,25,0.000017
Balkans,,,4,25,29,37,0.000018
Fyromia,,,7,21,28,37,0.000034
Macedonia,,,6,3,9,37,0.000019
Bulgaria,,,14,20,34,37,0.000051
Balki,,,6,22,28,9,0.000017
Big Bag,,,8,11,19,63,0.00004
Crystal ball,,,13,86,99,2,0.00003
Neuticles.com,,,5,24,29,25,0.000023
Nutsack,,,6,7,13,54,0.000027
Manhunt,,,14,90,104,22,0.000022
Dr. Comet,,,5,26,31,31,0.000014
Dealer,,,31,36,67,35,0.000034
I have a lot of,,,9,26,35,35,0.00004
Flash Mob,,,4,14,18,35,0.000012
Balloonpoppop,,,4,15,19,12,0.000012
Bam Margera,,,7,61,68,0,0.000023
Heartagram,,,1,10,11,12,0.000011
Bambifan101,,,14,40,54,2,0.000035
Long-term abuse,,,10,9,19,2,0.000016
The Rescuers,,,3,44,47,37,0.000014
Teletubbies,,,17,15,32,34,0.000039
The Oogieloves in the Big Balloon Adventure,,,1,23,24,7,0.000011
Jiminycricketfan007,,,4,35,39,53,0.000022
Mr Wiki Pro,,,1,3,4,2,0.000011
BanGene,,,2,13,15,17,0.000012
Farm Town,,,19,17,36,49,0.000035
Game of Thrones,,,26,123,149,42,0.000042
Naked Banana,,,5,16,21,9,0.000015
Bananadine,,,3,13,16,35,0.000018
Bananaphone,,,17,28,45,53,0.000024
John Bulla,,,2,5,7,53,0.000012
Banat,,,2,70,72,37,0.000012
Moldova,,,12,22,34,37,0.00004
Great,,,10,27,37,12,0.000021
Now,,,21,30,51,3,0.000033
Yiri,,,10,33,43,48,0.000024
Bandcamp,,,2,10,12,12,0.000012
Lapfox Trax,,,6,27,33,31,0.000014
Beebee890,,,4,19,23,48,0.000013
Unlimited disposable income,,,41,9,50,8,0.000075
Nipples removed to save bandwidth,,,4,9,13,9,0.000012
Bandwidth Raep,,,6,20,26,10,0.000033
Bandwidth envy,,,2,16,18,39,0.000025
Uncle Dolan,,,41,22,63,9,0.000068
So cash/variations,,,9,65,74,9,0.000016
OBEY,,,11,64,75,33,0.000034
Banjo Kazooie,,,21,83,104,49,0.00003
Encyclopedia Dramatica:Orphan,,,6,0,6,39,0.000013
FUBAR,,,12,28,40,21,0.00002
Conker's Bad Fur Day,,,7,31,38,49,0.000028
Yooka-Laylee,,,8,27,35,49,0.000015
Penisbird,,,17,6,23,63,0.000065
Modern Warfare 2,,,37,177,214,49,0.000041
Lel,,,25,6,31,9,0.000044
Trolldin,,,23,12,35,41,0.000038
Invite code,,,3,8,11,8,0.000028
Tookie Williams,,,6,18,24,35,0.000023
What to do when your family disowns you,,,1,25,26,41,0.00002
Internet killers,,,9,18,27,8,0.000026
Jodi Arias,,,5,7,12,36,0.000023
Xat,,,11,97,108,24,0.000023
Me too-er,,,3,13,16,8,0.000021
June Maxam,,,3,13,16,26,0.000028
Username Bans,,,9,23,32,2,0.00003
Banned All Stars,,,2,17,19,57,0.000014
BanniNation,,,6,48,54,24,0.000015
Quiverfull,,,16,49,65,46,0.00003
Banshee1067,,,2,20,22,8,0.000016
Banshee1067/Vent-post,,,1,2,3,8,0.000011
J-Rock,,,26,78,104,28,0.000123
Things that don't exist,,,2,31,33,17,0.000011
Solipsism,,,1,8,9,41,0.000014
Memebot,,,1,1,2,41,0.000014
IRC Networks,,,8,97,105,41,0.000039
RLoxley,,,3,8,11,52,0.000015
Malice bd,,,3,14,17,8,0.000017
Areems,,,1,0,1,41,0.000014
Bantown/Schism aftermath chatlog,,,1,2,3,41,0.000014
Bantown proverbs,,,1,15,16,41,0.000014
Mugu,,,9,9,18,64,0.000026
Jerkcity,,,7,2,9,54,0.00003
Bantown quotes,,,1,0,1,41,0.000014
Kaufman prize,,,1,12,13,41,0.000014
Shining Force Central,,,5,9,14,21,0.000018
Old /b/ would have X,,,4,13,17,9,0.000011
Disagree,,,14,61,75,19,0.000022
Vegas,,,16,7,23,23,0.000025
Taxes,,,37,72,109,35,0.000047
Rahm Emanuel,,,6,62,68,14,0.000024
Liberal media,,,27,93,120,19,0.000139
Federal Reserve,,,12,17,29,17,0.00004
Dips Tobacco Redneck,,,4,32,36,14,0.000025
Reverend X,,,6,13,19,46,0.000022
ULTRANIGGER,,,7,9,16,35,0.000022
I am an American conservative shitheel,,,4,2,6,14,0.000023
Barbara Schwarz,,,3,17,20,26,0.000019
Mark Rathbun,,,3,1,4,26,0.000016
Liz Bateman,,,6,4,10,26,0.000016
Barbie,,,35,26,61,36,0.000073
Extreme Porn,,,6,29,35,39,0.000014
Bratz,,,7,22,29,36,0.000016
Venusangelic,,,10,52,62,63,0.00002
Barcelona Death Van 2017,,,0,13,13,19,0.000011
Barely Legal,,,11,7,18,36,0.000021
Barmer479,,,4,20,24,48,0.00002
Barney,,,8,2,10,34,0.000018
Barney and Friends,,,13,54,67,34,0.000025
Barneyfag,,,2,51,53,7,0.000015
Dora the Explorer,,,18,54,72,34,0.00003
Littlest Pet Shop,,,8,12,20,34,0.00002
Splatoon,,,10,34,44,49,0.000018
MandoPony,,,3,58,61,7,0.000012
Sethisto,,,26,38,64,7,0.000094
DisneyMaster,,,3,25,28,7,0.000011
Baroness Warsi,,,5,48,53,37,0.000017
Thatcher,,,4,24,28,2,0.000014
Silken Secret,,,5,10,15,40,0.000017
Jesse Osborne,,,3,23,26,58,0.000013
Conan O'Brien,,,10,1,11,19,0.000026
Death to all Juice,,,7,30,37,37,0.000028
Fiverr,,,5,9,14,40,0.000012
Spyro the Dragon,,,23,128,151,56,0.00005
Resting Bitch Face,,,1,2,3,12,0.000011
What is a man?,,,25,48,73,49,0.000039
Bodybuilder,,,62,61,123,0,0.00012
SportsOnly,,,3,22,25,40,0.000013
Creepypasta/Lost Episodes,,,3,2,5,22,0.000016
Lisa is a Vegan,,,4,22,26,25,0.000016
Bart the General,,,9,61,70,9,0.000032
YouTube View Fraud,,,21,56,77,48,0.000028
Mickey Mantle,,,3,1,4,35,0.000013
Bird,,,15,9,24,9,0.000037
Billy Martin,,,7,61,68,35,0.000016
Basement Cat,,,7,23,30,25,0.000046
Completist,,,7,14,21,17,0.000031
Uboa,,,6,41,47,9,0.000025
Caveatipse,,,10,83,93,9,0.000026
Collectoons,,,5,17,22,34,0.000023
Darkfalz,,,4,21,25,41,0.000022
Degen,,,5,26,31,9,0.000025
Demcad,,,4,6,10,17,0.000022
"Erik ""Tazman"" Mokracek",,,3,18,21,7,0.000023
Exhibit B,,,18,0,18,52,0.000077
Glasses Teenager,,,3,32,35,22,0.000024
Goodgirl 666,,,6,30,36,44,0.000023
Ground floor,,,12,16,28,8,0.000041
Gsnfag,,,4,54,58,0,0.000036
Jamie Baillie,,,9,25,34,41,0.000038
John Skelton,,,2,28,30,8,0.000023
King Of The Nerds,,,9,41,50,46,0.000052
LAN Party,,,13,32,45,10,0.000041
Pantaloons,,,2,19,21,0,0.000029
Raukue,,,16,67,83,31,0.000061
Spending too long on the internet,,,8,22,30,31,0.00003
Trey Eric Sesler,,,5,17,22,58,0.000025
Tom Galloway,,,12,34,46,33,0.000036
Yoshi-lord,,,7,26,33,21,0.000025
Zane1193,,,3,32,35,14,0.000022
Bash.org,,,14,37,51,41,0.000064
QuoteBucket.org,,,2,15,17,41,0.000012
Bashar al-Assad,,,9,41,50,37,0.000034
Tara Strong,,,48,143,191,7,0.000137
Bashurverse,,,1,10,11,53,0.000023
Basic accounts,,,3,44,47,8,0.000011
Bradfitz,,,31,18,49,8,0.000099
LiveJournal Buyout,,,9,25,34,8,0.000064
Dramatician,,,8,11,19,8,0.000045
The Great LJ Outage Of 2006,,,2,5,7,8,0.000011
Basin Hills Project Redux,,,2,7,9,9,0.000011
Operation Falcon Punch,,,14,65,79,9,0.000032
Bass,,,1,4,5,37,0.000011
Basshunter,,,2,2,4,37,0.000013
Boten Anna,,,5,25,30,37,0.000019
Brushie Bat,,,8,23,31,9,0.000028
Jax the Bat,,,9,36,45,21,0.000017
Batabii,,,2,24,26,31,0.000011
Pinkuh,,,5,73,78,31,0.000013
Programming,,,18,34,52,10,0.000031
QBASIC,,,8,10,18,10,0.000026
Meow Meow,,,6,16,22,35,0.000017
Research Chemicals,,,5,11,16,35,0.000016
Suicide Squad,,,6,47,53,35,0.000016
Jumpscare,,,1,0,1,34,0.000012
Roofie,,,1,0,1,34,0.000012
Your mother sucks cocks in Hell,,,10,11,21,4,0.000038
I seriously hope you guys don't do this,,,28,51,79,9,0.000065
Batman/Origin,,,1,4,5,34,0.000012
BatteryIncluded,,,3,21,24,2,0.000013
Starkiller88,,,11,67,78,2,0.000022
List of banned users,,,11,57,68,2,0.000019
Blunty3000,,,19,111,130,48,0.000027
Smpfilms,,,16,45,61,48,0.000022
Sxephil,,,28,59,87,48,0.000033
Katiesopinion,,,15,22,37,48,0.000017
UpDownMostly,,,24,65,89,48,0.000039
Warisart,,,7,21,28,48,0.000013
Gimmick,,,13,17,30,48,0.000017
Nalts,,,6,15,21,48,0.000012
I Don't Watch TV,,,14,53,67,18,0.000043
Sepia,,,5,28,33,40,0.000015
Gimmeabreakman,,,8,54,62,48,0.000012
ChangeDaChannel,,,3,17,20,35,0.000011
Battle.net Forums,,,8,101,109,49,0.000013
Warcraft 3,,,11,65,76,49,0.000015
BattleCam,,,2,2,4,1,0.00002
Battle For Dream Island,,,7,34,41,48,0.000017
Scratch,,,6,76,82,38,0.000014
Greeny Phatom,,,3,58,61,34,0.000012
Eddsworld,,,6,24,30,48,0.000019
Lock Legion,,,5,97,102,38,0.000014
Total Drama,,,13,128,141,0,0.000024
Battle Raper,,,7,11,18,39,0.000046
Battle of /q/,,,4,23,27,19,0.000014
Joseph Goebbels,,,3,21,24,37,0.000016
Columbiners,,,27,64,91,58,0.000045
Battle of Berkeley/Infobox,,,0,8,8,19,0.000011
Battlecry,,,5,16,21,35,0.000017
Battlefield 2,,,11,53,64,49,0.000028
Battlefield 2142,,,8,27,35,49,0.000019
Battlefield Heroes,,,7,119,126,49,0.000019
Battlefield Play4Free,,,2,11,13,49,0.000016
Battlefield 3,,,14,97,111,49,0.000029
Battlefield 1,,,4,13,17,49,0.00002
Battlefield: Bad Company 2,,,2,110,112,49,0.000014
Useless Human,,,3,3,6,53,0.000011
Juba the Baghdad Sniper,,,21,34,55,37,0.000035
EA Download Manager,,,8,31,39,49,0.000013
Turtleguy,,,5,9,14,9,0.000016
PunkBuster,,,9,57,66,49,0.000013
Cactus,,,9,19,28,41,0.000039
Force Push,,,8,8,16,9,0.000016
Pyro,,,26,37,63,4,0.000068
Monthly Collectibles,,,6,25,31,15,0.000023
Rocky Lockridge,,,2,13,15,64,0.000011
Battlenigras,,,2,7,9,12,0.000023
Lithuania,,,12,106,118,37,0.000038
Kaliph Jamal,,,7,46,53,40,0.000017
Rainbow,,,24,6,30,51,0.000047
Jessica Lyn Dickerson,,,6,19,25,41,0.000013
Regina,,,2,12,14,41,0.000012
Nathanr,,,45,76,121,2,0.000084
Internets English,,,16,61,77,9,0.000064
Buzzkilling,,,30,37,67,9,0.000059
Circumlolcution,,,3,11,14,40,0.000015
Bayonetta,,,11,14,25,49,0.000017
Hideki Kamiya,,,11,16,27,19,0.000017
Bbraefan1530,,,7,60,67,34,0.000019
Make me a sandwich,,,7,42,49,39,0.000067
Bcc,,,3,23,26,64,0.000014
Learn to noun,,,20,10,30,64,0.000062
Snopes,,,16,108,124,46,0.000022
Meninism,,,7,10,17,19,0.00002
Shill,,,13,6,19,19,0.00002
BeCandid/CEO,,,3,1,4,19,0.000013
BeCandid/Code,,,1,2,3,19,0.000012
BeCandid/nav,,,0,10,10,19,0.000011
BeCandid/Companies,,,1,0,1,19,0.000012
BeCandid/Cabalists,,,1,0,1,19,0.000012
BeCandid/Contracts,,,1,0,1,19,0.000012
BeCandid/CheesePizza,,,1,0,1,19,0.000012
Beamshipcaptain,,,1,35,36,23,0.000011
SPERMCUBE,,,4,20,24,20,0.000021
Gamelife,,,4,27,31,61,0.000012
ShaloneSK,,,3,60,63,56,0.000012
Yumi-Misaki,,,4,26,30,21,0.000012
Tumbears,,,4,36,40,40,0.000018
Tg/,,,12,62,74,9,0.000032
Opie and Anthony,,,22,166,188,17,0.000112
Prime Number Shitting Bear,,,5,6,11,40,0.000018
Vaping,,,6,23,29,19,0.000014
Coyote Peterson,,,1,31,32,13,0.000012
Beard Man,,,1,2,3,9,0.000014
Robert,,,3,24,27,58,0.000013
Kazantzakis,,,7,10,17,52,0.000015
TheAtheistGamer,,,4,38,42,7,0.000013
Sneakylizard,,,2,9,11,19,0.000011
Bearshare,,,6,18,24,53,0.000017
Napster,,,11,19,30,10,0.000021
Jeremy Bernal,,,10,29,39,31,0.000035
Bestiality Boy,,,2,4,6,9,0.000011
Beatmania IIDX,,,8,30,38,40,0.000016
Pop'n Music,,,6,15,21,40,0.000012
Simulation,,,1,0,1,40,0.000011
Konami,,,15,73,88,49,0.000019
JohnOfE,,,8,31,39,31,0.000025
Genesis,,,11,21,32,21,0.000027
Bebo Concerned,,,2,20,22,48,0.000012
Muscle,,,2,3,5,0,0.000012
My Fake Baby,,,4,14,18,39,0.000016
Bed bug,,,1,47,48,40,0.000011
Permabanning,,,1,0,1,40,0.000011
Bedford,,,10,107,117,2,0.000018
Krimpet,,,12,41,53,2,0.000029
Internet Watch Foundation,,,14,41,55,2,0.000038
Voted off the island,,,1,0,1,2,0.000011
WHY IS THEY AN SYSOPS?,,,4,0,4,2,0.000014
Daniel Woodward,,,4,35,39,7,0.000012
MicahFennec,,,9,27,36,31,0.000021
Bee,,,3,7,10,9,0.000016
I'm on my bee,,,7,19,26,9,0.000025
Jameth Effect,,,5,6,11,8,0.000026
Beefcake,,,4,1,5,10,0.000013
RedMachineD,,,6,35,41,52,0.000013
D-malice,,,13,92,105,52,0.000017
Rate Your Music,,,3,36,39,12,0.000011
Encyclopedia Dramatica:Help,,,4,0,4,61,0.000028
Quasidan,,,34,10,44,8,0.000207
Begbucks,,,0,18,18,48,0.000011
Davidsfarm,,,12,83,95,48,0.000016
Beheading video,,,17,14,31,37,0.000044
Daniel Pearl,,,8,12,20,37,0.000032
Nick Berg,,,12,21,33,37,0.000039
Chechclear,,,9,10,19,22,0.000033
Narcovideo,,,6,12,18,37,0.000029
Being an Edgelord,,,1,20,21,7,0.000012
JDubs,,,10,42,52,46,0.000021
Belarus,,,3,6,9,37,0.000015
Hockey,,,25,103,128,32,0.000074
Belen Aldecosea,,,1,37,38,25,0.000011
Miami,,,20,50,70,35,0.000033
Gremblo,,,3,44,47,19,0.000012
My Husband,,,1,0,1,37,0.000012
Maggie de Block,,,4,5,9,52,0.000032
Koko Fresh Killa,,,1,2,3,58,0.000012
Eastern Europe,,,13,16,29,37,0.000039
Believe everything you read,,,7,22,29,3,0.000013
E-Trust,,,6,8,14,3,0.000017
Belinda Kovalskaya,,,0,13,13,21,0.000011
Valeria Lukyanova,,,1,14,15,21,0.000011
Bell,,,7,26,33,10,0.000018
The Virginmobile,,,20,14,34,8,0.000045
Captain Crunch,,,14,21,35,10,0.000021
Blue Box,,,8,10,18,10,0.000017
Oracle Corporation,,,13,12,25,10,0.000035
Masters of Deception,,,6,18,24,10,0.000018
Phiber Optik,,,3,17,20,10,0.000014
Plan9,,,4,12,16,10,0.000015
Bella and the Bulldogs,,,5,24,29,34,0.000013
Victorious,,,6,51,57,34,0.000015
Bellaboo,,,1,19,20,36,0.000011
Datura,,,3,14,17,35,0.000018
Belome,,,3,13,16,9,0.000011
Beltboy,,,7,18,25,8,0.000019
Victoria4usa,,,8,9,17,8,0.000032
Rant about cons,,,23,29,52,8,0.000045
Kamuela,,,5,8,13,8,0.000018
Throwingstardna,,,5,10,15,8,0.000022
Ratherberucking,,,13,16,29,8,0.000061
Bemmel,,,1,22,23,37,0.000011
Kittenwar,,,7,22,29,37,0.000047
Poop drama,,,5,26,31,8,0.000022
Marcel Dootjes,,,6,23,29,35,0.000013
Ben,,,1,17,18,15,0.000011
Ben400,,,1,30,31,39,0.000011
Ben Ford,,,2,93,95,7,0.000011
Ben Johnson,,,9,34,43,14,0.000023
Ben Schumin,,,2,71,73,15,0.000011
CheekyBen,,,7,71,78,21,0.000016
Evil-unveiled.com/Dannywyatt,,,5,4,9,43,0.000014
Benny Lava,,,3,22,25,15,0.000014
Benny the Snake,,,2,3,5,15,0.000015
Sharpie,,,16,5,21,17,0.000031
Macrophile,,,38,76,114,31,0.000076
PilgrimJohn,,,10,63,73,21,0.000019
Resist.com,,,6,45,51,35,0.000017
Ben Garrison/JIDF Version,,,1,20,21,19,0.000012
Larry Craig,,,57,42,99,14,0.000111
RapeLay,,,11,44,55,39,0.000049
TheMarySue,,,28,144,172,19,0.000059
The Escapist,,,17,3,20,19,0.000017
Ben Moynihan,,,3,8,11,58,0.000013
Thomas Watt Hamilton,,,12,31,43,58,0.000021
Chris-chan/Wikipedia,,,4,54,58,19,0.000011
The Onion,,,20,80,100,15,0.000028
Steven Crowder,,,2,10,12,19,0.000014
Erowid,,,7,19,26,35,0.000029
Coincidence,,,35,25,60,38,0.000042
Bender,,,3,7,10,34,0.000012
Europimp,,,3,7,10,12,0.000012
Benjamin Fischbein,,,0,7,7,38,0.000011
Translation,,,4,26,30,37,0.000012
Caiden Cowger,,,6,48,54,14,0.000013
Soulbrothanumbuh3,,,6,40,46,34,0.000012
WikiScanner,,,7,37,44,2,0.000013
Didaskalos,,,15,57,72,43,0.000149
Berd,,,4,28,32,21,0.000017
Getting away with it,,,6,43,49,35,0.000012
Bernie Mac,,,4,25,29,35,0.000023
Client 9,,,15,104,119,36,0.000036
Flag Burners,,,8,30,38,8,0.000075
Vermont,,,15,16,31,19,0.00003
Rekt,,,22,49,71,19,0.000026
Jeremy Corbyn,,,12,33,45,37,0.000023
Michele Bachmann,,,11,29,40,14,0.000019
Berry,,,0,2,2,14,0.000011
Justin Berry,,,8,14,22,19,0.000019
Berryboy,,,4,13,17,22,0.000012
Berserk,,,7,24,31,28,0.000021
Fate/stay night,,,8,67,75,28,0.000021
Bert and Ernie,,,1,9,10,19,0.000011
Coincidence Detector,,,22,33,55,19,0.000078
Muppets,,,34,83,117,34,0.000041
BestGore,,,9,21,30,6,0.000014
The Interview,,,4,16,20,37,0.00002
Time Magazine Polls,,,2,22,24,9,0.000012
Kim,,,1,10,11,37,0.000012
Theneedledrop,,,16,54,70,12,0.00003
Hulu,,,7,30,37,34,0.00002
Harvester,,,2,66,68,37,0.000017
WolfJLupus,,,29,36,65,31,0.000042
Motherless.com,,,22,84,106,39,0.000167
Dykepals,,,7,6,13,54,0.00005
Milwin,,,4,28,32,52,0.000021
Bravestarr,,,7,11,18,31,0.00003
Carl Paladino,,,6,39,45,14,0.000024
Darkhorseman,,,10,13,23,31,0.000033
Douglas Spink,,,6,42,48,31,0.000026
Jasha Lottin,,,5,16,21,33,0.000045
Rahsarah91,,,6,39,45,36,0.000026
Shaun Ellis,,,6,31,37,31,0.000027
Steven Bonnell II,,,11,41,52,19,0.000048
Beta Uprising,,,7,26,33,58,0.000019
Betabyteiphone,,,2,52,54,48,0.000013
IRC Client,,,4,37,41,10,0.000033
Native,,,3,67,70,37,0.000016
The Elder Scrolls,,,18,1,19,49,0.000027
Brink,,,5,54,59,0,0.000014
Fallout: Shadow of Boston,,,14,225,239,49,0.000021
Betty,,,0,11,11,44,0.000011
The Soapbox,,,16,90,106,44,0.000019
Daney21,,,3,8,11,3,0.000015
Hells Angels,,,6,7,13,46,0.000019
Tweeker,,,1,0,1,46,0.000014
Preacher717,,,5,32,37,46,0.000018
Tijuana bibles,,,6,36,42,39,0.000035
Bible slash,,,14,30,44,6,0.000037
Elton John,,,28,37,65,12,0.000057
Bidoof,,,9,49,58,9,0.000023
Smogon University,,,17,142,159,15,0.000028
I'm Dying Squirtle,,,7,8,15,9,0.000022
Bieberisafag,,,2,19,21,12,0.000012
Big-Robo,,,1,18,19,42,0.000011
BigBadFurgyTheFox,,,1,18,19,48,0.000011
BigKneeLover,,,0,28,28,36,0.000011
Neko,,,8,55,63,28,0.000014
Sierra Leone,,,4,12,16,64,0.000015
Ministry of truth,,,4,12,16,8,0.000014
Paulie Calafiore,,,2,85,87,57,0.000013
Big Daikon,,,4,26,30,28,0.000023
NOVA,,,4,107,111,28,0.000028
Slashdot effect,,,5,11,16,10,0.000021
Big Red,,,15,20,35,39,0.000028
Mini meme,,,17,20,37,9,0.00005
The War Z,,,2,34,36,49,0.000012
Bigbadron,,,6,25,31,4,0.000014
Wade Fulp,,,8,27,35,4,0.000029
Never work,,,1,0,1,41,0.000011
Biggest Video Game Nerd,,,0,10,10,61,0.000011
Heterophobia,,,6,30,36,40,0.000015
Mike Tyson's Punch Out,,,6,38,44,35,0.000018
Robert Stewart,,,2,7,9,53,0.000014
Bikerfox,,,20,84,104,53,0.000039
Bike Cuck,,,6,12,18,19,0.000018
Motorcycle,,,13,34,47,35,0.00003
Bike safety,,,3,22,25,41,0.000012
"Peter Jennings died, so I'm going to quit smoking",,,11,38,49,14,0.000031
Guru,,,4,4,8,48,0.000013
LoganSperman2,,,26,58,84,48,0.00004
Church of Fudge,,,12,24,36,22,0.000033
Bilano,,,6,7,13,41,0.000013
Bill,,,7,34,41,26,0.000039
Bill Mitchell,,,11,16,27,26,0.000017
Evil-unveiled.com/Siva,,,4,4,8,43,0.000013
Bill Waggoner,,,5,30,35,56,0.000015
Bill122460,,,6,62,68,39,0.000016
Bill Spider,,,8,21,29,41,0.000018
Gee Bill,,,7,30,37,9,0.00002
Jailhouse Gay,,,25,14,39,39,0.000108
Chismah,,,10,53,63,39,0.00004
Kevin Provance,,,12,59,71,41,0.000043
Cookies,,,16,59,75,17,0.000029
Bill9929/logs,,,1,0,1,32,0.000012
Creepypasta/Retarded Creepypasta,,,6,9,15,9,0.000019
Dragon-goddess,,,5,66,71,38,0.000014
Burger,,,8,35,43,41,0.000026
Lyndon Johnson,,,13,58,71,17,0.000041
Chelsea Clinton,,,14,62,76,19,0.000062
Shut up judge,,,12,5,17,31,0.000025
Botox,,,3,4,7,19,0.000011
Netorare,,,12,98,110,22,0.000023
Rachel Dolezal,,,22,50,72,35,0.000046
Unrapeable,,,19,68,87,39,0.000022
Fuck Her Right In The Pussy,,,14,18,32,57,0.000024
Revolutionary Girl Utena,,,10,118,128,28,0.000032
Woody Allen,,,26,24,50,17,0.000039
Bill Cosby/Twitter's Verdict,,,0,25,25,17,0.000011
Black Twitter,,,6,19,25,35,0.000016
IBM,,,25,57,82,10,0.000064
MSDN,,,2,10,12,10,0.000014
Coding,,,5,34,39,10,0.000018
Visual Studio,,,2,0,2,10,0.000013
Tech Support,,,10,20,30,10,0.000022
Marathon,,,4,46,50,49,0.000015
Windows Optimizer,,,9,18,27,10,0.000033
Quizilla,,,13,40,53,27,0.000019
Louis C.K.,,,20,104,124,17,0.000094
Emacs,,,7,17,24,10,0.000018
Evil-unveiled.com/Lux,,,9,7,16,43,0.000079
Preteen Pageant,,,2,36,38,36,0.000012
Tom,,,12,28,40,12,0.000023
Jerry from Doomsday Refreshment Committee,,,8,30,38,12,0.000026
Substantia,,,3,6,9,26,0.000013
Gurkirat Vig,,,4,20,24,26,0.000014
Netflix,,,15,13,28,19,0.000023
Moonie,,,6,7,13,26,0.000019
GAME OVER YEAHHHH,,,20,13,33,49,0.000037
Cultural appropriation,,,18,13,31,19,0.000024
WHAT HAS SCIENCE DONE?,,,5,16,21,46,0.000019
Top Gear,,,6,79,85,32,0.000034
Drinkingwithbob,,,4,45,49,14,0.00002
Michael Savage,,,17,87,104,14,0.000051
You can't explain that,,,4,5,9,52,0.000015
Bill S.978,,,0,18,18,13,0.000011
Bill Schmalfeldt,,,7,85,92,55,0.000039
Daily Kos,,,16,38,54,14,0.000032
Spanking Art Wiki,,,11,32,43,2,0.000022
Paranoid personality disorder,,,5,15,20,26,0.000015
Jizz Cake,,,1,1,2,55,0.000011
Kthxbye,,,24,13,37,53,0.000037
David Thorne,,,8,44,52,41,0.000059
Debi Daly,,,4,54,58,56,0.000014
Billf,,,1,3,4,41,0.000013
Billiam,,,3,2,5,8,0.000013
Featherfag,,,9,29,38,7,0.000039
Pivot Stickfigure Animator,,,5,21,26,24,0.000016
The Boss,,,8,69,77,35,0.000019
Soap opera,,,24,18,42,21,0.000083
Billy Mitchell,,,0,17,17,58,0.000011
Todd Rogers,,,3,100,103,58,0.000015
Bimbofication,,,10,20,30,36,0.000014
Binary,,,12,4,16,49,0.000026
Sorry,,,33,85,118,14,0.000055
Dexter,,,12,73,85,60,0.000051
Bindyboo98,,,1,15,16,7,0.000011
Delivery-chan,,,3,24,27,9,0.00002
LMGTFY,,,3,10,13,9,0.000044
Powerpoint Presentation,,,8,16,24,25,0.000019
Google Killer,,,7,20,27,10,0.000021
Binghar,,,0,3,3,11,0.000011
Binkers,,,3,11,14,25,0.000019
Birthday,,,10,13,23,54,0.000033
Video Game Critic,,,4,9,13,61,0.000012
Fable 2,,,6,96,102,49,0.000013
ShrekChan,,,18,51,69,9,0.000034
BioShock Infinite,,,9,54,63,49,0.000044
Warframe,,,4,27,31,4,0.00002
Frat boy,,,9,58,67,40,0.000033
Mass Effect,,,38,138,176,49,0.000033
Dragon Age: Origins,,,4,180,184,35,0.000012
Jennifer Hepler,,,6,21,27,49,0.000014
Biofurs,,,15,37,52,31,0.000037
Expansion Mansion,,,6,56,62,22,0.000013
Greg Mazujian,,,4,108,112,7,0.000018
Birdemic,,,6,56,62,34,0.000018
The Room,,,24,96,120,34,0.000039
Troll 2,,,10,5,15,34,0.000029
Birmingham Pagan Community,,,5,23,28,25,0.000021
Garwy,,,5,11,16,41,0.000016
Misterpoet,,,5,4,9,53,0.000022
Birthday29,,,0,1,1,8,0.000011
Williamsledd,,,8,8,16,48,0.00002
Emosexuality,,,14,41,55,12,0.000045
Bishie syndrome,,,22,63,85,21,0.000032
YaoiGoddessKeale,,,4,54,58,21,0.000013
Yumix,,,4,50,54,21,0.000011
Kurohime,,,6,58,64,28,0.000018
Vanillakitsune,,,8,69,77,24,0.000014
HitmanN,,,5,56,61,28,0.000014
BitKeeper,,,1,4,5,10,0.000012
OSDL,,,2,12,14,10,0.000015
Bram Cohen,,,2,13,15,10,0.000013
Poop.mov,,,11,57,68,41,0.000049
Matt Sanchez,,,4,36,40,14,0.000014
Snob,,,28,30,58,21,0.00004
Cancerr,,,9,85,94,6,0.000016
UTorrent,,,8,54,62,10,0.000018
BitView,,,1,29,30,48,0.000011
VidLii,,,5,83,88,48,0.00002
ZippCast,,,9,62,71,48,0.000022
Heather Lind,,,14,37,51,39,0.000153
Bitch I look like Goku,,,4,19,23,28,0.000019
Kim Petras,,,11,33,44,12,0.000032
Nuttymadam3575,,,15,120,135,32,0.000024
Garbage Day,,,12,18,30,9,0.000035
Videocompiler,,,10,45,55,1,0.000026
The Empire of Arkantos,,,4,22,26,40,0.000013
Germano Mosconi,,,3,9,12,46,0.000012
Star Wars Fanon Wiki,,,10,50,60,2,0.00002
Broncofn90,,,3,29,32,48,0.000012
Drago-dracini,,,8,50,58,21,0.00002
Blazesonic,,,19,64,83,21,0.000026
Petrozza,,,3,27,30,9,0.00002
My Love For Yuna,,,1,21,22,36,0.000012
Chris Stone,,,17,79,96,8,0.000028
StarCraft II,,,14,161,175,49,0.000021
Diego Maradona,,,7,34,41,35,0.000014
Tidus,,,8,3,11,29,0.000014
Woah Vicky,,,14,39,53,35,0.00009
Bitchiekittie,,,1,2,3,48,0.000013
Backdoor,,,1,0,1,17,0.000012
Paycoin,,,2,14,16,17,0.000014
Dogecoin,,,6,40,46,9,0.000017
ED Tshirt Contest,,,1,2,3,26,0.000012
Cheryl Lindsey Seelhoff,,,6,63,69,26,0.00002
BitingBeaver/MoralityClausesECAndBrokenCondoms,,,1,2,3,26,0.000012
Biting Beaver/forest,,,1,13,14,39,0.000012
BitingBeaver/SScomments,,,1,2,3,26,0.000012
BitingBeaver/MoarComments,,,1,5,6,26,0.000012
BitingBeaver/Screenshots,,,1,2,3,26,0.000012
Shakesville,,,8,13,21,39,0.000021
Chauvinist,,,1,0,1,26,0.000013
Looting,,,25,9,34,35,0.000057
Pleb,,,9,11,20,17,0.00002
Foursquare,,,5,37,42,13,0.000022
BitsyTalk,,,2,19,21,9,0.000015
Skateboard-City,,,6,15,21,51,0.000014
BlackBerry,,,4,27,31,10,0.000013
BlackSquad,,,1,1,2,10,0.000016
Black Bloc,,,4,12,16,14,0.000015
Black Butler,,,4,53,57,28,0.000013
Black Christmas,,,5,30,35,39,0.000014
Sorostitute,,,5,19,24,36,0.000027
Black Diligent,,,0,31,31,35,0.000011
Boxing,,,5,17,22,35,0.000013
The Great Thread Scare of Friday 13th,,,5,118,123,32,0.000013
Black Hole,,,6,32,38,46,0.000027
Sir Isaac Newton,,,4,15,19,46,0.000012
Tobacco,,,8,18,26,13,0.000045
D.A.R.E.,,,2,26,28,32,0.000011
Laquan McDonald,,,3,38,41,35,0.000012
ISWAP,,,4,36,40,35,0.000014
General Butt Naked,,,2,21,23,46,0.000012
Shaun King,,,14,11,25,35,0.000019
Ismaaiyl Brinsley,,,2,15,17,35,0.000012
Cosmo Setepenra,,,4,31,35,35,0.000013
Dead Nigger Storage,,,6,13,19,35,0.000014
Body camera,,,4,15,19,35,0.000012
Black Market Reloaded,,,1,27,28,13,0.000011
Deep web,,,18,48,66,13,0.000057
Uber,,,37,10,47,12,0.000049
Metal-Archives,,,6,61,67,12,0.000015
The Greatest Story Ever Told,,,6,1,7,46,0.000018
Noise music,,,6,53,59,12,0.000015
Hot or Not,,,10,53,63,52,0.000029
Fandom Secrets,,,19,88,107,28,0.000041
VelvetFlowingAura,,,3,37,40,59,0.000014
Black Panther,,,4,26,30,35,0.000014
Eleanor de Freitas,,,2,50,52,39,0.000012
Black Phoenix Alchemy Lab,,,6,34,40,36,0.000017
Mung,,,5,20,25,21,0.000029
Gazi Kodzo,,,2,7,9,35,0.000012
Taylor Swift Ex Boyfriend Shirt,,,16,21,37,63,0.000051
Black man,,,0,2,2,41,0.000011
Blackbird,,,3,22,25,10,0.00002
Blackfrost,,,4,29,33,31,0.000028
Blackinese,,,2,33,35,28,0.000013
Blackmage9,,,6,105,111,21,0.000019
Blackpride-brownlove,,,1,7,8,21,0.000012
Marius1867,,,2,5,7,21,0.000013
Blackup,,,9,30,39,32,0.000018
Blaire White,,,2,7,9,19,0.000022
Reply Girls,,,9,26,35,36,0.000019
Riley Dennis,,,4,19,23,19,0.000019
Blake,,,3,23,26,8,0.000018
Blake Judd,,,0,25,25,12,0.000011
Three Wolf Moon,,,8,18,26,0,0.000017
Heavenablaze,,,2,70,72,12,0.000011
Keyboard Cat,,,17,33,50,9,0.000026
Lucario,,,30,89,119,31,0.000035
Ditto,,,14,22,36,28,0.000027
Cloyster,,,5,24,29,39,0.000032
BlazBlue,,,7,46,53,49,0.000012
Matsu-sensei,,,2,45,47,23,0.000011
Blaze Arctic,,,6,40,46,31,0.000016
Dylan Tnga,,,13,32,45,49,0.000016
Blazger,,,5,31,36,31,0.000012
Brock,,,4,3,7,28,0.000014
Muscle March,,,6,19,25,0,0.000018
But What Are Your Thoughts On Yaoi?,,,10,28,38,28,0.000076
Leekspin.com,,,17,16,33,9,0.000026
Bledel,,,1,18,19,26,0.000011
GreatestJournal,,,12,33,45,8,0.000047
Divierto,,,2,11,13,26,0.000012
Fuanon,,,4,19,23,26,0.000013
BleedingFireWolf,,,6,21,27,24,0.000012
Evana,,,5,14,19,21,0.000013
Bleedingelite,,,2,24,26,36,0.000011
Realitysquared,,,29,33,62,21,0.00003
Blindmute Loli,,,8,60,68,53,0.000035
Blindmute Loli/December 2007,,,12,11,23,53,0.00003
Opera Browser,,,8,27,35,10,0.000028
Blindmute Loli/June 2007,,,12,180,192,53,0.000032
Blindmute Loli/July 2007,,,12,187,199,53,0.000032
Blindmute Loli/August 2007,,,12,11,23,53,0.00003
Blindmute Loli/September 2007,,,12,11,23,53,0.00003
Blindmute Loli/October 2007,,,12,11,23,53,0.00003
Blindmute Loli/November 2007,,,12,11,23,53,0.00003
Blindmute Loli/January 2008,,,12,11,23,53,0.00003
Blindmute Loli/February 2008,,,12,11,23,53,0.00003
Blindmute Loli/March 2008,,,12,11,23,53,0.00003
Blindmute Loli/September 2008,,,12,11,23,53,0.00003
My Strange Addiction,,,8,50,58,31,0.000048
One does not simply X into Mordor,,,40,17,57,9,0.000042
How are you feeling today /b/?,,,3,25,28,9,0.000015
Bob Saget,,,27,30,57,61,0.000029
Solid Snake's Ass,,,13,4,17,49,0.000021
Elite Beat Agents,,,4,105,109,40,0.00002
Childlove,,,24,25,49,8,0.000045
Pie,,,36,16,52,52,0.000085
Smugleaf,,,16,38,54,9,0.000031
Smell Yo Dick,,,14,36,50,39,0.000044
Excuse me wtf r u doin,,,3,9,12,53,0.000011
COCKMASTER,,,5,0,5,39,0.00002
Internet license,,,3,15,18,2,0.000013
Oh No You Didn't,,,8,20,28,9,0.000012
Diamonds,,,8,19,27,35,0.00002
Blingee,,,6,74,80,9,0.000033
Show Bellybutton,,,7,18,25,9,0.000029
Sparkling Wiggles,,,24,29,53,48,0.000042
Blink,,,3,6,9,10,0.00002
Marquee,,,11,15,26,8,0.000053
Blip,,,5,28,33,61,0.000026
Google Video,,,5,23,28,48,0.000018
Somey,,,12,31,43,2,0.000019
Grace Note,,,12,26,38,2,0.000018
Encyc,,,7,32,39,2,0.000015
Guild Wars,,,10,58,68,49,0.000026
Diablo II,,,17,63,80,49,0.00002
Diablo III,,,9,79,88,49,0.000016
Hearthstone,,,4,48,52,49,0.000018
Heroes Of The Storm,,,2,7,9,49,0.000015
Redwall,,,6,106,112,21,0.000014
Covercat,,,11,8,19,9,0.000041
Parakeets,,,5,4,9,9,0.000029
Blockbuster,,,5,37,42,35,0.000014
Blockhead,,,1,12,13,57,0.000011
Torque Game Engine,,,6,13,19,58,0.000014
Tribes 2,,,4,44,48,49,0.000014
Civilization,,,8,70,78,0,0.000015
Sacha Baron Cohen/Other Characters,,,8,104,112,41,0.000016
Blockland/Drama,,,1,42,43,7,0.000011
Lowti3rgod,,,5,23,28,7,0.000012
BlogTV,,,17,63,80,48,0.000021
Broadcaster,,,9,147,156,18,0.000043
TeenChat,,,2,13,15,53,0.000011
TinyURL,,,10,12,22,2,0.000023
Shane Dawson,,,29,47,76,48,0.000067
MannixThePirate,,,3,10,13,46,0.000015
Gary Brodsky,,,2,74,76,17,0.000013
Blogger's Code of Conduct,,,1,8,9,50,0.000011
Blogs4Brownback,,,2,21,23,6,0.000013
Blonde angel13,,,0,15,15,18,0.000011
Blondie xoxo,,,4,71,75,36,0.000012
Buttercup Duck,,,7,16,23,41,0.000013
WickedPrincess,,,6,40,46,44,0.000012
Blonic,,,3,18,21,7,0.000013
Blood (Speakonia),,,0,30,30,24,0.000011
WhiteMystery,,,8,36,44,2,0.000022
Fair Game,,,9,67,76,26,0.000018
Portal:Music,,,3,0,3,52,0.000012
Old Spice Guy,,,16,82,98,9,0.00003
Façade,,,9,85,94,19,0.00002
Bloodborne,,,5,13,18,49,0.000015
Dark Souls,,,14,25,39,49,0.000021
Dark Souls 2,,,7,4,11,49,0.000016
Bloodlent,,,1,16,17,12,0.000011
Bloodninja,,,19,13,32,41,0.000047
Bloodninja/logs,,,2,1,3,41,0.000019
Bloodraptor,,,4,24,28,11,0.000016
Bloodshows.com,,,2,16,18,6,0.000012
Rotten,,,5,6,11,6,0.000016
Bloodydiaperman,,,4,15,19,34,0.000016
Blowback,,,8,24,32,26,0.000016
Jonathan Gaskins,,,4,28,32,9,0.000024
Shane Brown,,,3,11,14,26,0.000019
Ricers,,,24,30,54,35,0.000033
MER-C,,,5,0,5,2,0.000014
Samsara,,,5,25,30,2,0.00002
Blu Aardvark/Whiteman22,,,1,17,18,37,0.000012
Bludshot the Hedgehog,,,6,163,169,27,0.000015
Fists The Echidna,,,10,55,65,21,0.000019
Blue-Six,,,2,4,6,35,0.000011
MLG,,,12,29,41,7,0.00002
Sparkalloon,,,7,33,40,31,0.000013
Sonofss2,,,1,15,16,7,0.000011
Cave Story,,,6,38,44,49,0.000015
Darlalloons26,,,5,26,31,7,0.000013
Chibiyima,,,11,90,101,7,0.000021
CJ-The-Pikachu,,,1,24,25,7,0.000011
Kphoria,,,6,60,66,21,0.000013
BlueMario1016,,,5,51,56,7,0.000016
Doomer3868,,,2,44,46,7,0.000011
TheJewelKitten,,,3,33,36,24,0.000011
Clear Channel,,,4,17,21,14,0.00002
Damien Estreich,,,20,24,44,48,0.00002
YourTubeNews,,,13,24,37,48,0.000023
UTubeDrama,,,9,50,59,48,0.000014
Misleading thumbnail,,,8,13,21,48,0.000035
YouTube Staff,,,16,46,62,48,0.000029
BoA,,,10,21,31,28,0.00005
Utada Hikaru,,,7,46,53,28,0.000018
Serial Experiments Lain,,,6,60,66,10,0.000017
Board Games,,,2,17,19,35,0.000011
Boars heart,,,2,16,18,40,0.000012
Boat,,,0,4,4,35,0.000011
Scooter,,,5,57,62,52,0.000025
Boaty McBoatface,,,0,5,5,19,0.000011
The Aristocrats,,,18,58,76,41,0.000061
Bob,,,6,18,24,9,0.000015
Bob Allen,,,9,23,32,14,0.000017
Bob Frantz,,,4,9,13,41,0.000013
Bob Griese,,,2,9,11,35,0.000015
Bob Minton,,,4,8,12,26,0.000012
Bob Rehahn,,,21,40,61,48,0.000078
Bob Sager,,,4,23,27,9,0.000012
Bob's Game,,,8,47,55,49,0.000016
Not-Bob,,,5,13,18,21,0.000013
This is Bob,,,2,15,17,9,0.000011
RPG Maker,,,11,46,57,49,0.000016
Postal 2,,,18,60,78,37,0.000024
Sex Panther,,,4,1,5,35,0.000015
Throwaway,,,8,34,42,53,0.00002
Whiteguys fartinmyface,,,5,10,15,34,0.000013
Olsen Twins,,,16,57,73,52,0.000049
Bobba Bar,,,4,13,17,10,0.000013
North Carolina vandal,,,5,28,33,2,0.000012
Reggie Fils-Aime,,,8,12,20,49,0.00002
Tim Schafer,,,13,65,78,19,0.000016
Bobbyq78,,,2,15,17,8,0.000011
Themoonfell,,,3,12,15,8,0.000012
Nonuglyfats,,,7,19,26,8,0.000018
Sine Nomine,,,2,13,15,12,0.000014
Random Idiot,,,2,12,14,12,0.000046
Bodrochowski,,,3,10,13,48,0.000011
Body Pillows,,,23,32,55,28,0.000043
Camera,,,3,20,23,8,0.000014
Body dysmorphic disorder,,,6,29,35,52,0.00002
Whale Wars,,,9,39,48,25,0.000026
Lanketer,,,1,19,20,21,0.000012
P90X,,,7,40,47,9,0.00002
Bogans,,,25,27,52,1,0.000079
Great Western Highway pole,,,6,21,27,1,0.000015
Justin Mully Williams,,,2,16,18,1,0.000014
Boh3m3,,,16,24,40,48,0.000022
DiGiTiLsOuL,,,9,18,27,48,0.000029
Boi,,,4,15,19,40,0.000014
Cory Doctorow,,,14,25,39,42,0.00002
Jokestress,,,9,12,21,2,0.000024
Will Beback,,,11,22,33,2,0.000019
The Daily Dot,,,15,4,19,19,0.000044
BoingBoing vs Violet Blue: Strap-on Smackdown!,,,0,67,67,42,0.000011
John,,,8,45,53,49,0.000016
Lesbian Break-Up,,,11,10,21,42,0.000035
Lesbian Bed Death,,,17,17,34,42,0.000041
Boirozzlyn,,,0,17,17,63,0.000011
Ultimate Muscle Roller Legend,,,8,14,22,0,0.000017
Shounen Maid Kuro-Kun,,,4,12,16,28,0.000021
Trancy.Mick,,,10,38,48,31,0.000025
Bolt,,,4,34,38,4,0.000018
Template:Swastika,,,1,0,1,4,0.000011
Bomani Armah,,,1,7,8,35,0.000023
Riding Dirty,,,12,8,20,35,0.000035
Bomberman,,,3,3,6,7,0.000016
Bomberman (Game),,,3,48,51,49,0.000016
Bombermanfan/Logs,,,1,2,3,10,0.000011
Bombshock,,,6,17,23,4,0.000014
Darknet,,,11,14,25,10,0.000036
Hurrchan,,,8,39,47,32,0.000018
RottenEggs,,,10,78,88,4,0.000018
Bonbonchuu,,,0,7,7,13,0.000011
Bond,,,1,3,4,37,0.000011
Bonnie Combs,,,1,3,4,42,0.000011
Bonsai Kitten,,,18,27,45,25,0.00004
Jarcat,,,2,4,6,25,0.000012
Bonzi b,,,7,11,18,51,0.000016
The Great ED IRC War of 2013,,,6,26,32,10,0.000015
Ironic and Meme Rap,,,6,15,21,12,0.000039
WhiteMystery's Dog,,,2,3,5,2,0.000012
Boob Nazis,,,17,21,38,8,0.000031
Booju mooju,,,2,5,7,8,0.000012
CF Hardcore,,,8,23,31,8,0.000021
LJDrama boobs,,,4,9,13,8,0.000019
The Internet Is For Porn,,,3,22,25,1,0.000011
Boochan,,,7,6,13,2,0.000013
Booger,,,1,13,14,49,0.000011
Boogeyboy1,,,1,15,16,21,0.000011
Otherland,,,5,19,24,41,0.000016
Necronomicon,,,9,17,26,27,0.000026
Public Library,,,9,62,71,14,0.00002
Bookz,,,7,7,14,41,0.000017
Bookmark,,,1,15,16,8,0.000011
Encyclopedia Dramatica/Bookmarklet,,,1,4,5,10,0.000011
Nao,,,15,19,34,60,0.00004
Bookofglitter,,,1,19,20,12,0.000013
Dune,,,6,44,50,35,0.000014
DMOZ,,,9,9,18,10,0.000036
My Little Pony/Berry Punch,,,3,0,3,7,0.000019
Slayerduck,,,2,7,9,28,0.000018
Subculture,,,12,61,73,12,0.000031
Chaosscizzors/Autobiography,,,2,0,2,28,0.000013
Rule34.com,,,8,21,29,9,0.000016
Wiktionary,,,6,13,19,2,0.000016
Booster4444,,,1,18,19,32,0.000011
IFavTrash,,,5,59,64,21,0.000012
Booty Shaking,,,13,46,59,39,0.000044
Borderlands,,,17,172,189,49,0.000016
Duke Nukem,,,30,8,38,49,0.000046
Wolfenstein,,,17,12,29,49,0.00002
Misunderstood,,,1,0,1,12,0.000011
Dark angel,,,4,50,54,52,0.000018
Vera,,,4,14,18,31,0.000051
Bored photoshops,,,2,3,5,21,0.000011
Mr Beast,,,5,63,68,38,0.000023
Borgore,,,3,38,41,12,0.000014
Boris Johnson,,,6,26,32,37,0.000014
Nigel Farage,,,13,27,40,37,0.000023
It's Not My Fault I'm Not Popular,,,18,33,51,28,0.00004
Boris Malagurski,,,1,8,9,37,0.000014
Yuki Damon,,,7,31,38,29,0.000021
GNU,,,11,31,42,10,0.000024
Mark Wahlberg,,,16,65,81,37,0.000044
Ted Bundy,,,20,39,59,36,0.000059
Strutting Leo,,,18,45,63,9,0.000026
Harlem Shake,,,6,19,25,37,0.000013
Curps,,,4,15,19,2,0.000015
Eliza,,,3,8,11,39,0.000014
Rosa Helikopter,,,4,14,18,37,0.000019
Bothan spy,,,4,12,16,33,0.000019
Unidentified Rodian with jacket,,,7,11,18,33,0.00002
Star Wars: Knights of the Old Republic,,,6,120,126,33,0.000016
Bot army,,,1,0,1,10,0.000013
Femdom,,,4,6,10,39,0.000024
Bowchan,,,1,5,6,28,0.000011
Boxxmom,,,4,58,62,9,0.000014
CatieWayne.com,,,11,121,132,9,0.000092
Unichan,,,8,36,44,9,0.000021
Tabby,,,9,37,46,9,0.000027
BoyChat,,,215,15,230,43,0.001592
Evil-unveiled.com/BoyChat,,,1,42,43,43,0.000101
BoyWiki,,,12,12,24,43,0.00006
Evil-unveiled.com/BoyWiki,,,1,2,3,43,0.000015
Boychan,,,0,9,9,53,0.000011
Boycott,,,1,25,26,14,0.000011
Boyd Doghouse,,,1,26,27,7,0.000011
Manlytears,,,22,139,161,7,0.000037
IntLib,,,9,19,28,31,0.000017
~js,,,7,79,86,48,0.000012
Boylove,,,5,20,25,53,0.000018
Thick,,,2,5,7,42,0.000013
ProJared,,,10,18,28,19,0.000018
Smug,,,16,6,22,19,0.00002
Faulty Logic,,,20,37,57,39,0.000036
Ultima Online,,,12,47,59,49,0.000018
Damnportlanders,,,3,50,53,8,0.000017
Bradford Cox,,,1,12,13,40,0.00002
Bradleh Daw Gaim,,,2,29,31,28,0.00002
Bradman,,,3,8,11,9,0.00002
Braeburned,,,1,25,26,7,0.000011
South Dakota,,,6,63,69,35,0.000013
Foalcon,,,1,0,1,7,0.000011
Drawn Sex,,,15,22,37,34,0.000031
Braid,,,2,41,43,49,0.000012
BrainPOP,,,0,18,18,7,0.000011
Brainfuck,,,5,2,7,10,0.000016
Brainlesswonder,,,17,30,47,8,0.000032
Kkk membership,,,7,14,21,8,0.000018
Dancingdrew,,,7,6,13,8,0.000034
TMBW;DR,,,1,6,7,8,0.000012
Theory,,,9,32,41,46,0.000026
Susan J. Elliott,,,15,121,136,26,0.000042
Braixen,,,7,40,47,31,0.000015
Zoroark,,,9,50,59,31,0.000017
FemaleGoodra,,,5,33,38,7,0.000026
Huggle,,,8,42,50,2,0.000014
Numberofthebeatz,,,4,84,88,21,0.000012
Lissachoa,,,2,35,37,21,0.000011
Complete,,,7,8,15,6,0.000055
Brandon,,,0,10,10,43,0.000011
Evil-unveiled.com/Dacarus,,,5,6,11,43,0.000016
Brandon Kessler,,,6,40,46,26,0.000017
Brandonkeys,,,4,73,77,17,0.000013
Evil-unveiled.com/Brandon Low,,,5,4,9,43,0.000026
Brandon Phillips,,,3,13,16,41,0.000012
List of sex moves/Part2,,,29,53,82,39,0.000055
Moving to Canada,,,10,51,61,14,0.00002
Friendwhore,,,6,19,25,8,0.000019
Tom O C,,,4,13,17,12,0.000012
Brandon Hilton/Arbchat with Brandon's manager,,,1,0,1,40,0.000011
Brian Mueller,,,9,99,108,7,0.000027
TheTruthHurtsNetwork,,,4,11,15,7,0.000012
PhunWithLogic,,,4,35,39,7,0.000013
MarblesPoundcake,,,8,40,48,7,0.000015
Indigo Children,,,17,25,42,58,0.000028
Diet Pills,,,7,24,31,52,0.000017
Teen Titans Go!,,,6,38,44,34,0.000018
Duck,,,9,15,24,9,0.000015
Honey Boo Boo,,,9,56,65,52,0.000016
Uncle Grandpa,,,10,74,84,34,0.000014
Video Brinquedo,,,9,19,28,34,0.000013
Braumsgirl26,,,3,15,18,38,0.000011
Bravesgirl5/Chat logs,,,1,1,2,48,0.000011
Jedi,,,25,24,49,33,0.000112
Tibia,,,8,114,122,8,0.000066
PTchan,,,3,7,10,37,0.000015
SkOt,,,1,8,9,58,0.000013
Something is on fire,,,7,10,17,41,0.000016
"Brb, compromised/The Science",,,2,7,9,9,0.000011
Theb0lt,,,2,0,2,9,0.000011
Clique,,,25,15,40,8,0.000033
Royco Cup of soup,,,5,17,22,9,0.000014
Bread (Meme),,,1,9,10,9,0.000014
Dancing Sandwich,,,21,13,34,9,0.000044
Breadsona,,,1,29,30,31,0.000014
Break,,,3,32,35,48,0.000011
Breaking Bad,,,28,85,113,35,0.000033
The X-Files,,,19,63,82,17,0.000031
Portmanteau,,,24,85,109,2,0.000092
Screamer,,,15,51,66,22,0.000024
Hal Wilkerson,,,6,27,33,9,0.000014
Wayhne El Porch,,,11,39,50,9,0.000033
I don't think you have an X. Enjoy your Y.,,,8,33,41,9,0.000027
MyDeathSpace,,,11,31,42,41,0.000019
Disconnection,,,5,8,13,26,0.000012
Pseudocide,,,14,12,26,12,0.000042
Gay Drama 2006,,,6,15,21,8,0.000016
Iron Man Numbers,,,8,29,37,48,0.000015
Galactic Federation of Light,,,11,33,44,46,0.000017
Breda Highschool Massacre,,,6,33,39,9,0.000014
"‎Tim Kretschmer",,,1,0,1,9,0.000011
Jessy1019,,,3,44,47,46,0.000014
Missravenx,,,6,41,47,8,0.00006
Chantelle Steadman,,,6,43,49,36,0.000019
Parenting,,,4,27,31,36,0.000019
Breitscheidplatz,,,6,14,20,37,0.000015
Brenda Ann Spencer,,,5,68,73,58,0.000012
San Diego,,,13,66,79,35,0.000025
Porsche Girl,,,13,53,66,36,0.000016
Clarissa,,,7,63,70,9,0.000013
Patrick Purdy,,,4,29,33,58,0.000015
Mamoru Takuma,,,5,5,10,58,0.000013
Korryn Gaines,,,6,83,89,35,0.000014
Dianne Feinstein,,,5,99,104,19,0.000012
Isabella Valentine,,,11,29,40,36,0.000031
Juggalette420,,,7,86,93,40,0.000016
Tricia Walsh-Smith,,,4,23,27,36,0.000012
Salvatore Rivieri,,,6,27,33,3,0.000021
The Beer Pong Massacre,,,5,67,72,14,0.000013
Twitterbook,,,2,7,9,19,0.000014
"French Presidential Election, 2017",,,1,10,11,19,0.000011
"Death to Traitors, Freedom for Britain",,,5,23,28,19,0.000012
Brian,,,0,18,18,34,0.000011
Realman1000000000000,,,2,18,20,48,0.000011
Panty Boy,,,3,2,5,3,0.000012
Brian Salcedo,,,1,36,37,10,0.000011
Brian Williams,,,5,19,24,34,0.000033
Evil-unveiled.com/Tamachan,,,3,1,4,43,0.000011
The Ultimate Warrior,,,7,26,33,15,0.000018
Brian Connors,,,0,13,13,35,0.000011
The Ranting Community,,,26,80,106,7,0.000024
Emery Bowman,,,9,28,37,7,0.000014
NateTalksToYou,,,8,54,62,7,0.000014
RanterInShades,,,6,24,30,7,0.000013
Laci Green,,,19,30,49,19,0.000021
Philosopher Attack,,,6,3,9,41,0.000025
Tyler Garmany,,,6,12,18,46,0.000014
Toledo,,,8,41,49,35,0.000021
H-wing,,,4,9,13,40,0.000015
Security Faggots,,,13,21,34,10,0.000015
Brianna,,,0,5,5,17,0.000011
Princess Breanna,,,1,7,8,17,0.000012
Brianna Brochu,,,3,29,32,35,0.000011
Epithet,,,1,0,1,35,0.000011
Taking A Break,,,5,8,13,19,0.000012
Chloe Sagal,,,16,103,119,19,0.000034
The Moon,,,24,46,70,46,0.00006
PC Master Race,,,21,46,67,49,0.000033
Ready Player One,,,1,3,4,24,0.000012
House of the Dead,,,2,49,51,49,0.000012
ParkourDude91,,,19,110,129,7,0.00003
Scoutgender,,,7,47,54,38,0.000024
Brianna Wu/Did Brianna Wu Ever Leave Her Home in Mid-October,,,1,4,5,59,0.000011
Paper trail,,,1,22,23,17,0.000014
Guilty Gear,,,3,76,79,28,0.000017
Smoke Weed Everyday,,,3,6,9,35,0.000013
Color,,,8,26,34,35,0.000026
T-Shirt,,,7,5,12,35,0.000022
Brigit Lorena Gonzalez,,,0,18,18,58,0.000011
Doom 3,,,13,35,48,49,0.000028
Pacifism,,,8,20,28,14,0.000017
Brinks Home Security,,,11,42,53,9,0.000026
The Crackhead,,,9,26,35,35,0.000036
Religion of peace,,,1,0,1,12,0.000011
Lenny Prank Calls,,,1,18,19,37,0.000011
Arguably,,,1,0,1,36,0.000011
Jeremy Kyle,,,16,80,96,42,0.000023
Kek,,,21,5,26,19,0.000029
Shanespannercock,,,2,33,35,40,0.000015
Likes,,,9,89,98,57,0.000021
Operation Yewtube,,,7,70,77,12,0.000029
David Mudkips,,,5,20,25,37,0.000019
Southerner,,,1,0,1,36,0.000014
Homosensual,,,6,25,31,40,0.000014
YouTube Super Fags,,,11,18,29,48,0.000019
Habitaquo,,,3,8,11,41,0.000014
Britta,,,1,29,30,21,0.000011
Brittany,,,0,6,6,18,0.000011
Brittany Venti,,,13,85,98,19,0.000018
FSJAL,,,16,60,76,9,0.00003
Chad,,,8,11,19,58,0.000016
MBTI,,,3,95,98,55,0.000013
Le 56 Face,,,9,31,40,19,0.000019
Nakedgirlparts,,,11,17,28,18,0.00004
Category:Portals,,,4,0,4,49,0.000019
Broady Paul Ledet,,,3,8,11,0,0.000018
Cupcake Dog,,,5,9,14,9,0.00002
Brock Turner,,,9,23,32,39,0.000032
What is Brock?,,,9,20,29,35,0.000035
Slacktivism,,,16,48,64,19,0.000022
Kimberly Jackson,,,1,1,2,39,0.000012
Tinder,,,15,53,68,19,0.00003
Rap Genius,,,8,42,50,12,0.000017
Guess the Gender,,,12,16,28,12,0.00003
Hyphy,,,13,27,40,35,0.00003
Hollywood Undead,,,10,47,57,12,0.000026
BrokeTheInterweb,,,3,42,45,14,0.000011
Joe Wilson,,,4,2,6,14,0.000018
Gloom,,,7,27,34,40,0.00006
BrokenSpacebar,,,0,6,6,64,0.000011
Cat on a keyboard in space,,,7,3,10,9,0.000019
Brokengirl1985,,,1,19,20,35,0.000011
Broknashleydoll,,,2,24,26,8,0.000011
Broly,,,2,62,64,0,0.000014
M.U.G.E.N,,,15,138,153,49,0.000027
Hulk,,,6,2,8,0,0.000026
Goku Vs Superman,,,9,87,96,28,0.000017
E-Tantrum,,,12,12,24,7,0.000015
Foul Bachelor Frog,,,7,3,10,7,0.000025
PPPProject,,,3,41,44,22,0.000015
Moleman9000,,,9,44,53,7,0.000018
Cease and Desist,,,16,17,33,10,0.000035
Jerry Springer,,,26,50,76,35,0.000047
YouTube Furry War,,,23,73,96,31,0.000022
Steam Powered Users' Forums,,,6,55,61,49,0.00002
MLP Forums,,,4,68,72,7,0.000018
Masem,,,4,11,15,2,0.000018
PikaPetey,,,2,31,33,7,0.000015
ToonKriticY2K,,,7,28,35,7,0.000019
Brookers,,,5,41,46,14,0.000012
Carson Daly,,,6,20,26,14,0.000016
Jason Steele,,,3,63,66,32,0.000011
Brooklynlover,,,2,30,32,21,0.000014
Gargoyle,,,4,26,30,31,0.000014
Bros Icing Bros,,,3,33,36,40,0.000022
Philosoraptor,,,8,2,10,9,0.000026
Brother Nathanael,,,0,30,30,17,0.000011
Brother and Sisters,,,3,6,9,42,0.000047
Browlzin,,,0,8,8,37,0.000011
Brownsquirrel,,,2,47,49,31,0.000011
Dragonfan,,,6,21,27,31,0.000013
Browser MMO,,,2,24,26,49,0.000013
Bruce,,,0,12,12,40,0.000011
Bruce Campbell,,,13,36,49,49,0.000037
Evil-unveiled.com/Hagar,,,3,3,6,43,0.000012
Bruce McMahan,,,3,22,25,40,0.000011
Bruce Wagner,,,1,5,6,38,0.000011
Bruce Waugh,,,1,9,10,28,0.000011
Melodramatic,,,11,33,44,12,0.000016
Kim Kardashian,,,24,51,75,36,0.000103
Fallon Fox,,,3,5,8,19,0.000013
Khloe Kardashian,,,3,55,58,36,0.000014
Lila Perry,,,8,19,27,19,0.000032
Bunny Pancake,,,14,28,42,9,0.00002
David After Dentist,,,5,15,20,48,0.000014
Nullcherri,,,3,3,6,8,0.000015
Minthoney,,,4,15,19,8,0.000016
Sniffing,,,4,17,21,10,0.000015
Bryci,,,8,37,45,36,0.000016
Sophie Lancaster,,,8,34,42,42,0.000024
Bsklgn,,,2,34,36,51,0.000011
Masochistic-Wolfie,,,5,92,97,36,0.000014
Rennies,,,17,29,46,51,0.000041
Degrassi.tv,,,6,24,30,8,0.000021
Goosh Goosh,,,20,31,51,28,0.000042
Bubs4696,,,4,30,34,53,0.000012
Skyboy,,,2,19,21,53,0.000011
Bubsy,,,0,13,13,0,0.000011
Buck Bumble,,,10,15,25,9,0.000031
Kale,,,15,52,67,52,0.000027
IQ Test,,,8,5,13,9,0.000033
Dante,,,3,19,22,9,0.000012
Mr. Bucket,,,7,19,26,53,0.000029
Bucky Bunny,,,7,47,54,10,0.000014
Dive,,,4,28,32,31,0.000014
Bud smiley,,,2,13,15,55,0.000013
Citadel,,,18,36,54,55,0.000073
ISCABBS,,,6,15,21,55,0.000016
Filter,,,3,11,14,21,0.000014
The Rapeman,,,8,16,24,39,0.000025
Sui-Chan,,,3,14,17,3,0.000032
Hidoshi,,,3,32,35,28,0.000012
Chan Ho Park,,,7,12,19,35,0.000033
Stoner-chan,,,3,7,10,9,0.000014
Buffering,,,13,41,54,10,0.000045
I CAN SEE THE FUTURE!,,,2,27,29,64,0.000012
The Bloody Board,,,4,42,46,19,0.000013
The Highgate Vampire,,,7,38,45,38,0.000018
Concerned Women,,,7,29,36,46,0.000017
Screencapped,,,1,0,1,36,0.000019
Bukkake Milk,,,6,14,20,20,0.00007
Isranon,,,4,12,16,36,0.000019
Cum Collector,,,4,3,7,20,0.000064
Milky,,,2,11,13,9,0.000016
Bulbagarden,,,9,93,102,0,0.000018
Twice,,,9,26,35,13,0.000033
PokeShipping,,,3,56,59,20,0.000014
Stoneman Douglas High School gun control activists,,,12,50,62,19,0.000018
You amuse me,,,8,10,18,46,0.00002
Scruncher or Folder,,,3,18,21,37,0.000037
Joe Biden,,,14,2,16,14,0.000045
Everything2,,,6,27,33,2,0.000088
Bully (Video Game),,,3,25,28,58,0.000015
Columbine Copycats,,,14,82,96,58,0.000026
Do you believe in god,,,8,10,18,58,0.000017
Bully Hunters,,,4,44,48,19,0.000011
Zombie Nazi,,,2,4,6,53,0.000011
Survivor,,,4,9,13,39,0.000012
Jonah Mowry,,,5,41,46,12,0.000015
Weegeeisgoingtokillm,,,7,65,72,7,0.00004
Donna Simpson,,,5,56,61,52,0.000033
Misha Silenosti,,,12,67,79,13,0.000038
ChildLine,,,2,24,26,13,0.000019
Bullystoppers,,,3,27,30,10,0.000012
Fanny,,,3,4,7,39,0.000014
Relevant to my interests,,,29,4,33,9,0.000088
Bump war,,,3,20,23,41,0.000013
Yuffie Bunny,,,7,13,20,28,0.000021
"Bunny, I have killed a cop",,,2,8,10,37,0.000014
Irina Dobrzhanskaya,,,1,10,11,37,0.000012
Pussyhawks,,,14,11,25,58,0.000021
Buprenorphine,,,1,39,40,35,0.000011
Internet trial,,,12,10,22,8,0.000033
HighInBC,,,10,33,43,2,0.000019
Gwen Gale,,,4,23,27,36,0.000016
Jdforrester,,,8,13,21,2,0.000019
Jehochman,,,6,10,16,2,0.000019
Jéské Couriano,,,6,98,104,2,0.000014
MuZemike,,,6,6,12,2,0.000015
Ryan Postlethwaite,,,4,34,38,2,0.000014
WJBscribe,,,3,12,15,2,0.000013
Werdna,,,3,16,19,2,0.000013
Strwbrri shrtck/Chatlog,,,2,3,5,2,0.000015
Chibiabos,,,6,10,16,31,0.000015
Lmao,,,47,17,64,24,0.000066
Chip Berlet,,,8,44,52,2,0.000018
Lyndon LaRouche,,,13,47,60,2,0.000023
Requests for adminship,,,9,41,50,2,0.000028
Milgram Experiment,,,8,21,29,2,0.000029
List of heterosexual Wikipedia admins,,,10,0,10,2,0.000036
Tourist guy,,,10,17,27,37,0.000019
Fast Food,,,7,13,20,35,0.000035
Koran Man,,,4,23,27,37,0.000013
Muslim Massacre,,,12,88,100,37,0.000022
TGcomix,,,15,149,164,32,0.000025
RHJunior,,,6,73,79,31,0.000015
BurningLJ,,,5,95,100,21,0.000012
Luigispiritkeeper08,,,5,40,45,21,0.000015
VICE,,,26,54,80,19,0.000034
Leave me alone,,,17,16,33,5,0.000041
Grunge,,,29,81,110,12,0.000098
Bustle.com,,,0,1,1,54,0.000011
Mistystuffer,,,8,31,39,28,0.000014
Girlfartlover,,,7,20,27,19,0.000033
But Data does not weight,,,8,6,14,9,0.000018
Fandom wank,,,14,14,28,8,0.00004
Cute Shit,,,4,35,39,22,0.000019
But you are died!,,,11,18,29,9,0.000024
Two of my friends died,,,7,12,19,9,0.000015
My mom just died,,,12,21,33,8,0.000031
Butchyjene,,,4,54,58,12,0.000016
Third person,,,3,2,5,61,0.000014
Impersonation,,,4,4,8,2,0.000021
Buttertroll,,,8,15,23,52,0.000017
Butterfly Kisses,,,27,16,43,43,0.000139
Evil-unveiled.com/Butterfly Kisses,,,3,38,41,43,0.000019
Lesbian pedophilia,,,10,18,28,39,0.000033
Manuel Uribe,,,4,12,16,52,0.000017
Fatass Denial Bloggers,,,8,10,18,52,0.000046
Butterymufkin,,,1,6,7,52,0.000013
MRI,,,10,31,41,52,0.000068
Buttes,,,19,57,76,10,0.000033
Figlet,,,2,8,10,10,0.000014
Grog,,,9,20,29,41,0.000017
Chirpnet,,,2,12,14,26,0.000011
Paxil,,,5,30,35,8,0.000014
Radium,,,5,22,27,8,0.00002
DiKKy,,,5,17,22,41,0.00002
Trolltalk,,,12,97,109,9,0.00011
Fuzzy mazza,,,3,33,36,39,0.000049
The Mulberry Eight,,,8,50,58,42,0.000049
Space Moose,,,13,25,38,47,0.00007
Mämmi,,,6,8,14,26,0.000096
Meek Mill,,,16,51,67,35,0.000183
Phil Shuman,,,5,10,15,26,0.000025
Staredog,,,13,23,36,9,0.000023
Five random items in a list you WONT believe you just clicked on,,,3,19,22,19,0.000012
Tobuscus,,,13,24,37,48,0.000018
Cryaotic,,,1,20,21,7,0.000011
Million Dollar Extreme,,,5,27,32,19,0.000012
Encyclopedia Dramatica:LULZ,,,2,0,2,3,0.000019
Chan Thread Watch,,,3,7,10,10,0.000016
Dump-chan,,,5,32,37,10,0.000022
Bwraep,,,1,1,2,10,0.000017
BwueMutt,,,3,21,24,31,0.000027
Similar,,,1,0,1,31,0.000012
Haydendaft,,,9,30,39,19,0.00003
Encyclopedia Dramatica:Why not pipe?,,,6,0,6,2,0.000078
Grudgewank,,,7,22,29,2,0.000014
Perl,,,26,27,53,10,0.000059
C++,,,0,27,27,10,0.000011
C+=,,,0,23,23,19,0.000011
Feminist Software Foundation,,,1,12,13,10,0.000011
Dark Age of Camelot,,,14,13,27,49,0.000041
Prokofy Neva,,,10,62,72,31,0.00002
C. Christine Fair,,,1,6,7,2,0.000011
Travis Mason-Bushman,,,13,42,55,2,0.000033
Special:AllPages,,,18,0,18,32,0.000036
CATS,,,0,11,11,2,0.000011
Not to be confused with x,,,6,11,17,6,0.00004
Ham,,,11,1,12,52,0.00008
CBF,,,4,3,7,13,0.000014
Mixtapes,,,14,46,60,12,0.000032
CH,,,0,14,14,37,0.000011
Christopher Harrison Jr,,,1,4,5,35,0.000011
Clive Hoyle,,,2,6,8,51,0.000012
ChatHour,,,2,105,107,37,0.000011
Company of Heroes,,,1,24,25,37,0.000011
CHIPPY1337,,,0,2,2,10,0.000011
CISPA,,,4,29,33,14,0.000012
Gingerslap,,,7,21,28,48,0.000015
CISSP,,,1,7,8,52,0.000015
Thomas,,,1,14,15,9,0.000011
CLAMP,,,2,37,39,28,0.000011
Tsubasa Chronicle,,,4,37,41,28,0.000015
COBOL,,,2,14,16,10,0.000013
Portal:Chans,,,2,3,5,9,0.000027
Jean Chretien,,,3,3,6,14,0.000029
Guitar,,,18,44,62,12,0.000041
Hiding Files,,,6,4,10,53,0.000028
Illcitvirus115,,,7,14,21,7,0.000032
João Bernardo,,,5,13,18,9,0.000031
KittenBellNSFW,,,14,63,77,53,0.000082
Stephen Sample,,,9,15,24,53,0.000064
Cascading Style Sheet,,,3,1,4,10,0.000013
Golden Road.net,,,7,5,12,61,0.000014
CYOC,,,8,37,45,31,0.00002
Cabinet,,,1,1,2,9,0.000011
SWTF,,,2,3,5,9,0.00002
Cactuar,,,9,24,33,9,0.000021
Sabotendar,,,1,5,6,16,0.000011
Caddicarus,,,5,26,31,61,0.000012
CutiePieMarzia,,,7,25,32,7,0.000014
Mythunderstood,,,5,35,40,52,0.000013
Centipede,,,13,3,16,59,0.000031
Rape dollars,,,12,13,25,17,0.000028
Phone sex,,,22,29,51,10,0.000034
Peppa Pig,,,5,34,39,34,0.00004
Cain and Abel,,,1,17,18,10,0.000011
Frosted Butts,,,11,10,21,9,0.000026
Cake shop,,,1,3,4,52,0.000015
Cakepony,,,3,17,20,53,0.000034
Cakeroll,,,5,13,18,9,0.000024
Duckroll,,,27,12,39,9,0.000067
I don't roll that way,,,7,17,24,9,0.000017
Cakey,,,0,14,14,17,0.000011
Pernicious Developers,,,1,11,12,10,0.000011
CaliHusky,,,3,27,30,31,0.000012
Icelyon,,,4,17,21,31,0.000012
Zapatistas,,,7,38,45,14,0.000037
Casey Serin,,,7,14,21,25,0.000062
Henry Waxman,,,4,39,43,17,0.000017
Miss California 2009,,,5,27,32,0,0.000015
Richard Chase,,,7,21,28,1,0.000036
Roy Ashburn,,,6,12,18,14,0.000021
The OC,,,9,29,38,34,0.000024
Rear Mission Devolved,,,4,19,23,49,0.000019
Trickshotting,,,6,24,30,49,0.000019
Call of Duty: Advanced Warfare,,,0,15,15,0,0.000011
Gasmask girl,,,1,0,1,40,0.000011
Call of Duty: Black Ops 2,,,0,92,92,63,0.000011
Darude - Sandstorm,,,3,2,5,4,0.000011
Rick James,,,18,15,33,17,0.000042
Gas Mask Girl,,,27,37,64,9,0.000065
Call of Duty: Black Ops 3,,,0,16,16,49,0.000011
Warhawk,,,3,52,55,49,0.000012
That rustled my jimmies,,,1,0,1,49,0.000011
Call of Duty: Black Ops 4,,,0,4,4,48,0.000011
Call of Duty: Ghosts,,,0,28,28,49,0.000011
Call of Duty: Infinite Warfare,,,0,12,12,57,0.000011
Call of Duty: WWII,,,0,3,3,49,0.000011
Medal of Honor,,,3,55,58,49,0.000016
Call of Duty: World at War,,,0,109,109,57,0.000011
Pube Muppet,,,8,33,41,4,0.000014
Klondikebar,,,4,25,29,4,0.000012
Pranknet,,,4,18,22,26,0.000014
CallumCartel,,,3,19,22,48,0.000011
Memorial page tourist,,,1,0,1,44,0.000011
The Daily Mail,,,30,66,96,37,0.000036
Calton,,,3,22,25,2,0.000015
Unblock,,,8,9,17,2,0.000019
Calum McSwiggan,,,1,28,29,19,0.000012
Patrick John Coleman,,,3,11,14,19,0.000012
Dilbert,,,18,21,39,61,0.000036
The Dilbert Hole,,,7,70,77,61,0.00003
Cambion-Hunter,,,1,30,31,19,0.000016
Jake Paul,,,6,10,16,48,0.000017
Zootopia,,,10,66,76,31,0.000032
WOLFABOO: The Movie,,,3,48,51,31,0.000014
Cringy,,,1,0,1,19,0.000011
Yoshiwii1,,,3,71,74,7,0.000014
Cambodian Midget Fighting League,,,2,5,7,63,0.000014
Camden,,,1,5,6,35,0.000012
CamelCase,,,2,10,12,2,0.000012
PmWiki,,,6,23,29,2,0.000015
Cephalopods,,,10,30,40,39,0.00003
Cyns,,,2,11,13,8,0.000013
Zananeichan,,,6,63,69,21,0.000026
Cameron Baker,,,1,7,8,19,0.000012
Cameron Shaw,,,7,64,71,46,0.000075
You must have been abused as a child,,,7,23,30,24,0.000014
KissingTheWolf,,,7,39,46,31,0.000016
Kiki Kannibal,,,21,118,139,36,0.00004
Campo Elías Delgado,,,8,34,42,58,0.000015
Campo Santo,,,6,23,29,19,0.000013
"NOBODY SET ANYTHING, LAZY FAGGOTS",,,5,16,21,19,0.000015
CampusBlender,,,2,4,6,6,0.000013
Camrose Cat Killers,,,9,25,34,25,0.000019
Melissa Bachman,,,7,14,21,28,0.000016
Deletionpedia,,,4,82,86,2,0.000011
Camwhore Calendar Project,,,5,0,5,39,0.00002
MemoryandDream,,,10,17,27,27,0.000031
Scarlet,,,16,13,29,8,0.000125
Vanity Is Perfection,,,3,37,40,36,0.000022
Martini-chan,,,11,12,23,9,0.000052
Emotion Eric,,,4,29,33,2,0.000034
Fatty-Tan,,,4,10,14,9,0.000023
Kristanicole,,,1,12,13,9,0.00002
List of Camwhores,,,6,50,56,9,0.00002
Pandora de La Salle,,,2,16,18,8,0.000028
WebCams,,,7,20,27,8,0.000048
Turk Diddler,,,8,35,43,12,0.000027
Canadian GunNutz,,,2,10,12,37,0.000013
Canadian Kid,,,0,9,9,10,0.000011
Canberra,,,3,13,16,11,0.000015
Nurse-kun/Damaged Goods,,,3,23,26,53,0.000029
Freewinds,,,6,15,21,26,0.000023
Gothreaper1,,,9,13,22,48,0.000035
Cancer Jesus,,,6,21,27,46,0.000057
Challenging god,,,3,19,22,46,0.000017
Otay,,,1,0,1,6,0.000011
Shitty advice,,,2,8,10,8,0.000011
Inadequacy,,,6,12,18,12,0.000016
Candice the Cuckslayer,,,1,9,10,19,0.000014
Niggerjack,,,8,13,21,9,0.000043
Copypasta/Archive 6,,,15,13,28,9,0.000088
Wikichan/Candlejack,,,1,1,2,26,0.000018
Candy (furry),,,1,20,21,31,0.000011
Canibus,,,4,20,24,12,0.000015
Fuck What You Heard,,,2,2,4,32,0.000014
OH MAN OH GOD,,,7,1,8,36,0.000014
Grotesque,,,2,36,38,39,0.000011
Graphic Violence,,,4,12,16,6,0.000023
Cannibalcountry,,,0,14,14,25,0.000011
Check your facts,,,14,16,30,8,0.000037
Canv.as,,,4,15,19,9,0.000017
Resident Evil 4,,,21,127,148,49,0.000034
Dino Crisis 2,,,6,47,53,49,0.000029
Dead Rising,,,8,104,112,40,0.000019
Pirat ponton,,,12,14,26,14,0.000042
EPoints,,,31,5,36,8,0.000078
Data,,,5,5,10,51,0.000021
Plastic Straws,,,6,16,22,15,0.000036
CapnOAwesome,,,6,34,40,46,0.000015
Capricornfox,,,3,68,71,21,0.000011
Khaaan!,,,13,5,18,37,0.000022
Caps,,,4,11,15,9,0.000022
CaptAWB1,,,2,85,87,5,0.000011
CaptainAtheist,,,2,9,11,46,0.000011
CaptainJamesman,,,2,47,49,32,0.000011
Captain Cornflake,,,5,21,26,26,0.000012
Zelda Universe,,,6,21,27,26,0.000015
Captain Jack,,,2,10,12,40,0.000012
Captain Nigga Defenda,,,1,5,6,12,0.000011
These Cuffs,,,5,17,22,35,0.00004
Captions,,,4,15,19,9,0.000022
Glitter's Cap-Page Board,,,6,12,18,61,0.000017
DMV,,,4,27,31,35,0.000015
Honda,,,1,8,9,37,0.000012
Malaysia,,,22,106,128,37,0.00005
Caraccident,,,1,10,11,8,0.000013
Stuff,,,11,6,17,37,0.000029
The Great Buttrape of Bloemfontein,,,4,35,39,60,0.000015
Orson Scott Card,,,6,142,148,46,0.000018
John Campbell,,,5,22,27,19,0.000012
Chris Kluwe,,,9,87,96,19,0.000019
Kotakoti,,,13,61,74,36,0.00002
CareerBuilder.com,,,2,20,22,35,0.000012
Carico,,,5,23,28,1,0.000022
Carl,,,1,6,7,19,0.000011
Carl Fiadino,,,2,15,17,51,0.000012
Oniontown,,,6,26,32,38,0.000013
Jersey Shore,,,49,126,175,57,0.000075
Carlos Deangelo Bell,,,1,36,37,39,0.000011
Check Your Privilege,,,13,56,69,19,0.000029
Rape Kit,,,6,3,9,39,0.000043
Sootyjared,,,8,50,58,7,0.000019
Jejejeje823,,,5,56,61,7,0.000014
UsurperBobO,,,1,38,39,37,0.000011
Carlos Romero,,,0,19,19,39,0.000011
Carlos Sousa Jr/Transcripts,,,1,1,2,60,0.000011
Staredad,,,4,12,16,9,0.000016
Francis,,,3,22,25,8,0.000012
Sharron Angle,,,6,21,27,14,0.000016
Carly Ryan,,,5,60,65,12,0.000017
Garry Francis Newman,,,2,8,10,12,0.000011
Sylvia Plath,,,4,11,15,12,0.000017
Radelaide,,,11,77,88,12,0.000026
Jeff Wood,,,6,88,94,40,0.000023
Carmencurbstomp,,,1,2,3,39,0.000012
Sunkist Carmen,,,1,0,1,39,0.000016
Carnegie Crow,,,1,4,5,9,0.000011
Carol Moore,,,2,21,23,2,0.000011
SF Drama,,,8,64,72,8,0.000015
Carolyn Bothwell Doran,,,5,26,31,2,0.000012
Danny Wool,,,12,23,35,2,0.00002
Madame Wikiwiki,,,9,45,54,2,0.000018
Shopping,,,1,0,1,14,0.000011
NBC.com Forums,,,3,11,14,6,0.000011
Cartoon All-Stars to the Rescue,,,7,43,50,35,0.000015
Cartoonjunkie,,,5,28,33,7,0.000011
Sandro L Jean,,,5,25,30,48,0.000014
Casemod,,,2,7,9,10,0.000012
Jee Jing,,,6,166,172,19,0.000016
Tiana Dalichov,,,2,41,43,19,0.000012
Casey Brezik,,,3,12,15,35,0.000013
Casey Neistat,,,2,7,9,19,0.000025
Fucked Company,,,5,29,34,14,0.000018
Deviantart Tickle Fetish Alliance,,,6,54,60,21,0.000017
Upper Decker,,,6,10,16,34,0.00061
Cash Items,,,4,20,24,49,0.000022
Cash Master,,,4,8,12,39,0.000011
Cassidy Dawn Graves,,,3,10,13,36,0.000014
Vanity search,,,5,11,16,28,0.000018
CassiusPlejarenAlien,,,5,77,82,48,0.000011
Colleen Thomas,,,2,12,14,17,0.000011
Castle Crashers,,,1,15,16,49,0.000011
Wench,,,1,0,1,49,0.000011
Simon Belmont,,,4,65,69,49,0.000012
ICVD,,,3,102,105,24,0.000011
Lifetime,,,8,39,47,39,0.00003
John Wayne Bobbitt,,,8,10,18,63,0.000042
City glitter,,,8,23,31,25,0.000034
Furshampoo,,,12,5,17,31,0.000036
Cat/Animated,,,1,1,2,25,0.000018
Cat/Captioned,,,1,44,45,9,0.000018
Cat/Fauxpics,,,1,5,6,25,0.000018
Cat/Costumes,,,1,2,3,25,0.000018
Meanwhile,,,8,23,31,37,0.000027
Cat/General,,,1,3,4,11,0.000018
Cat/Art,,,1,0,1,25,0.000018
Cat/Disturbing,,,1,1,2,25,0.000018
The Not-So-Great Frinkle Meme,,,4,5,9,57,0.000018
Tulip,,,3,6,9,9,0.000018
Death Cat,,,8,20,28,25,0.000038
Hipster Kitty,,,2,3,5,12,0.000018
Maru,,,5,22,27,25,0.000021
OMGWTFBBQCATS,,,2,8,10,25,0.000018
Sean Lynde,,,2,14,16,25,0.000018
Urlesque,,,1,0,1,25,0.000018
Rorschach,,,30,110,140,26,0.000056
Kloeri,,,9,15,24,41,0.000035
Red Dead Redemption,,,9,93,102,49,0.000033
Hwin/irclog,,,1,4,5,41,0.000014
Skratchgirl,,,1,0,1,8,0.000014
Cataclaw,,,1,7,8,24,0.000013
Catalano,,,1,2,3,37,0.000014
Catamorphism,,,4,24,28,2,0.000015
Hopkins Green Frog,,,8,8,16,8,0.000021
I Drink Your Milkshake,,,12,12,24,9,0.000021
Joe Mathlete,,,1,14,15,8,0.000013
Needs more cowbell,,,11,18,29,9,0.000074
What of it?,,,2,6,8,8,0.000014
Will verb again!,,,7,12,19,8,0.000029
Wtfuazrp,,,1,7,8,8,0.000013
Plenty of Fish,,,12,31,43,52,0.000023
Kemonomimi,,,7,52,59,28,0.000013
FLCL,,,8,62,70,28,0.000018
Chronic Troll Syndrome,,,21,26,47,41,0.00003
Safe Environment,,,4,12,16,46,0.000015
PostSecret,,,6,46,52,21,0.000015
Polish crosslol,,,7,38,45,9,0.000018
Demi Lovato,,,12,60,72,36,0.000017
Ytask,,,23,80,103,48,0.000037
Double Rainbow,,,9,26,35,51,0.000039
Olngact,,,8,15,23,25,0.000025
Ubersite,,,2,6,8,25,0.000014
Caulk,,,1,2,3,23,0.000011
ChadSyphrett,,,18,87,105,51,0.00004
Caveatipse/Chatlogs,,,1,4,5,22,0.000011
Caylenwolf,,,0,1,1,19,0.000011
Cbox Drama,,,1,9,10,21,0.000018
Iwrotetherules,,,3,19,22,8,0.000018
Graphic art,,,16,78,94,21,0.000032
CeLe/Logs,,,1,1,2,9,0.000011
Duncan,,,6,12,18,41,0.000017
Celestial Toystore,,,3,20,23,33,0.000012
High contrast,,,17,16,33,8,0.000066
Ringtones,,,4,20,24,10,0.000015
PhoneTrace,,,4,11,15,41,0.000013
Celsius,,,1,3,4,37,0.000011
CelticBrony,,,3,13,16,56,0.000013
Sean Connery,,,19,49,68,37,0.000038
EverQuest/Mystere,,,5,8,13,49,0.000019
The Video Professor 16,,,8,24,32,2,0.000018
Croik,,,2,22,24,39,0.000016
Central African Republic,,,0,16,16,37,0.000011
Central Michigan University Shooting,,,2,17,19,58,0.000012
Online quiz,,,14,15,29,7,0.000052
Crab,,,8,35,43,25,0.000016
Kraken's Ghost,,,8,44,52,28,0.000042
Cereal,,,4,5,9,2,0.000016
Wikichan/Cheerios,,,3,1,4,2,0.000026
Honey Bunches of Oats,,,3,5,8,2,0.000015
Lego Robot Comics,,,5,25,30,9,0.000031
Reeves,,,1,2,3,9,0.000012
Cerebus,,,2,33,35,30,0.000011
Cgunique,,,2,10,12,41,0.000011
Ch'marr,,,4,16,20,31,0.000012
VCL,,,15,18,33,31,0.000019
Spydar,,,3,24,27,31,0.000012
ChaCha,,,6,24,30,10,0.000017
"Chad ""Atheist Killa"" Elliott",,,3,48,51,46,0.000014
Evil-unveiled.com/Chad Frank,,,4,3,7,43,0.000015
Chad Lilly,,,1,18,19,46,0.000012
ChadSyphrett/ChadOnEDF,,,1,0,1,51,0.000011
ChadSyphrett/Gaia,,,1,2,3,33,0.000011
ChadSyphrett/Ranting,,,1,0,1,51,0.000011
ChadSyphrett/DAProjects,,,2,0,2,51,0.000011
ChadSyphrett/Accounts,,,1,0,1,51,0.000011
Favregeddon,,,9,46,55,18,0.00002
Simply Sara,,,9,43,52,52,0.000017
Red Link,,,8,5,13,2,0.000017
Internet Asshole,,,33,30,63,24,0.000056
Geriatric1927,,,3,15,18,48,0.000015
Fire drill,,,4,22,26,1,0.000027
Four,,,2,8,10,46,0.000012
Chagen46,,,6,14,20,31,0.000013
Chain letter,,,6,64,70,59,0.000027
Chaindix,,,3,54,57,1,0.000015
LOLCHAIR,,,7,15,22,9,0.000023
Living On A Prayer,,,7,35,42,9,0.000014
Resumé,,,5,20,25,35,0.000021
The Rejection Line,,,4,9,13,13,0.000014
Chakichakigirl,,,5,144,149,24,0.00002
Disturbed,,,4,2,6,24,0.000014
Original fiction,,,4,6,10,21,0.000014
Ryoukitten,,,7,39,46,21,0.000022
This is warmth,,,8,6,14,52,0.000021
Chameleon,,,7,16,23,9,0.000014
Wc3forum.tk,,,2,86,88,3,0.000011
Sub-chan,,,3,40,43,12,0.000013
Rat chan,,,3,9,12,63,0.000014
Shannon Schimpf,,,1,10,11,9,0.000013
Easter-chan,,,1,18,19,9,0.000013
Schoolchan,,,1,44,45,9,0.000013
Suicidechan,,,1,32,33,9,0.000013
Scar-chan,,,1,8,9,9,0.000013
Fapchan,,,6,25,31,18,0.000022
Futabachannel,,,3,19,22,9,0.000018
KonataChan,,,6,59,65,9,0.000014
Mewch,,,1,8,9,19,0.000013
NewFapChan,,,4,11,15,18,0.000013
OPERATORchan,,,7,18,25,0,0.000018
RockstarChan,,,10,74,84,9,0.000022
WTFchan,,,6,20,26,8,0.000051
Ychan,,,6,30,36,31,0.000013
Yuchan,,,2,5,7,9,0.000013
Nuclear-IB,,,1,0,1,9,0.000013
Chanapocalypse/irc logs/netcollect,,,1,5,6,9,0.000011
Chanapocalypse/irc logs/radio 1,,,1,5,6,9,0.000011
Chanapocalypse/irc logs/radio 2,,,1,5,6,23,0.000011
Jackal,,,4,54,58,10,0.000016
Sharolaid,,,8,53,61,48,0.000026
Lily Allen,,,7,77,84,36,0.000015
Reaction guy,,,20,32,52,9,0.000039
Chaos-the-fox,,,2,6,8,40,0.000011
Chaos wraith x,,,3,10,13,52,0.000012
Chapel of Resonance,,,2,25,27,40,0.000011
ChappelleTheory.com,,,2,4,6,6,0.000012
Char the Butcher,,,1,1,2,19,0.000015
Character hate,,,0,17,17,3,0.000011
Charizard,,,1,29,30,9,0.000011
Insanity Wolf,,,9,2,11,9,0.000046
Charles,,,0,17,17,58,0.000011
Charles Bukowski,,,6,91,97,35,0.000016
Evil-unveiled.com/Charles Carr,,,1,1,2,58,0.000011
Evil-unveiled.com/Chaos,,,2,6,8,43,0.000011
Charlestrippy,,,4,28,32,48,0.000012
Charles-wolfman,,,4,20,24,31,0.000012
Dancing Prince Charles,,,3,4,7,58,0.000012
Charlie Bit Me - Again!,,,4,17,21,48,0.000013
Joe Stack,,,7,25,32,17,0.000014
Godly Luck,,,6,16,22,9,0.000014
Charles Bunsvile,,,0,18,18,21,0.000011
Super Minecraft Kid,,,3,35,38,7,0.000019
Jim Profit,,,8,42,50,7,0.000038
Kthor,,,9,23,32,52,0.000018
Charles Rhines,,,0,17,17,40,0.000011
Linda Carty,,,5,53,58,35,0.000012
James Huberty,,,2,4,6,58,0.000012
Fighteer,,,3,74,77,2,0.000012
Sea-lioning,,,6,31,37,19,0.000018
Producing101,,,13,33,46,48,0.00002
Militant,,,3,9,12,8,0.000012
GoDaddy,,,10,40,50,24,0.000017
Private Eye,,,4,41,45,17,0.000013
I have 2 girlfriends and a truck fuck you,,,4,55,59,9,0.000038
Charlotte Charms,,,0,26,26,52,0.000011
Charmaine Dragun,,,6,17,23,58,0.000015
Perth,,,8,40,48,39,0.000019
Charter school,,,1,18,19,13,0.000011
Chase,,,2,4,6,21,0.000015
Things With Faces,,,7,27,34,9,0.000018
Jessica Brooks,,,5,59,64,35,0.000021
Pokemontrainer55,,,1,0,1,21,0.000011
Sapphiresama12,,,3,36,39,21,0.000012
Sandythewolfhusky,,,9,30,39,31,0.000019
Chat Avenue,,,3,33,36,3,0.000031
Goth Chat City,,,2,23,25,12,0.000015
IMVU,,,10,60,70,12,0.000019
Metawerx,,,1,11,12,31,0.000015
Paltalk,,,8,38,46,10,0.00002
Teenspot,,,7,107,114,38,0.000026
Blejus,,,1,0,1,37,0.000011
FOB,,,4,4,8,37,0.000014
Dangasm,,,6,57,63,60,0.000016
SweetNSour,,,2,7,9,34,0.000015
Leeb,,,1,0,1,60,0.000011
Chat Palace/Log1,,,1,6,7,3,0.000011
LOLGS,,,2,13,15,10,0.000014
DangerDan,,,12,11,23,48,0.000024
Nick Croce,,,5,11,16,1,0.000028
Chatango,,,4,36,40,36,0.000013
DynaCatlovesme,,,22,67,89,48,0.000038
Waitrose,,,2,27,29,42,0.000015
Ska,,,15,101,116,12,0.000027
Lady Sovereign,,,4,68,72,36,0.000015
Whistles go WHOO,,,17,28,45,35,0.000061
Ibiza,,,9,13,22,12,0.000026
ChavScum,,,5,48,53,12,0.000016
GotATeenager,,,2,45,47,47,0.000013
Kersal Massive,,,7,34,41,42,0.000015
Tyler Juett,,,4,42,46,33,0.000014
Reece Kent,,,2,10,12,42,0.000013
Leelad.net,,,2,32,34,61,0.000011
MixandMatch,,,2,4,6,53,0.000011
Cheat Code Wiki,,,3,12,15,2,0.000019
Hirsute,,,18,5,23,37,0.000055
CheckMiiOut,,,3,8,11,4,0.000011
Occupatio,,,14,6,20,41,0.000052
Professor Tim Pierce,,,7,32,39,2,0.000025
Toontown,,,10,68,78,31,0.000017
Kim Possible,,,9,66,75,34,0.000016
Wario,,,25,130,155,49,0.000052
CheekyBen/Chatlogs,,,1,1,2,50,0.000011
Cheeky Nando's,,,5,30,35,42,0.000023
The McNugget Burgler,,,4,11,15,39,0.000017
Cheetawolf,,,3,36,39,7,0.000011
Troll Science,,,7,20,27,9,0.000027
SMW Central,,,1,26,27,20,0.000011
Eddboy,,,1,71,72,15,0.000011
Mintchoco,,,5,46,51,21,0.000021
Shawn XYZ Beast,,,3,35,38,28,0.000016
Chekovsgun,,,1,5,6,52,0.000011
Chelle,,,3,15,18,27,0.000013
Fluffy,,,1,0,1,27,0.000011
Chelsea,,,0,20,20,19,0.000011
Chelsea Wynne Flaherty,,,1,0,1,19,0.000011
Defense Industries Organization,,,17,36,53,37,0.000044
Chemobear,,,0,8,8,53,0.000011
Chen,,,1,4,5,11,0.000013
M.I.A,,,6,3,9,35,0.000017
Cheryl Shuman,,,5,17,22,48,0.000014
Cherylite,,,1,3,4,2,0.000011
ChessCube,,,3,13,16,9,0.000011
Cross-post,,,3,17,20,8,0.000024
Chewfox,,,7,43,50,31,0.000032
Megaupload,,,16,31,47,9,0.000022
Chex Quest,,,3,12,15,49,0.000013
Latarian Milton,,,8,34,42,35,0.000013
LaraTheDarkAngel,,,10,59,69,25,0.000027
Lulz Map,,,5,519,524,2,0.000062
Chi-Chan24,,,14,118,132,34,0.000026
Fanime,,,8,61,69,28,0.000014
Screw up,,,1,0,1,34,0.000011
Trailor trash,,,1,0,1,34,0.000011
Dani Willow,,,12,17,29,53,0.000076
Dreachu,,,5,12,17,28,0.000014
Nixxiom,,,10,101,111,53,0.000038
TackyAnimationsX3,,,3,34,37,21,0.000012
Chiberita,,,3,43,46,21,0.000011
Chibi Faolan,,,0,26,26,39,0.000011
Leprechaun,,,9,0,9,59,0.000017
Chibiicap,,,5,93,98,31,0.000012
Mjbear,,,3,19,22,31,0.000011
LucidFox,,,5,25,30,2,0.000015
Chibixzaide,,,9,65,74,41,0.00003
MROE,,,1,3,4,21,0.000011
InvaderMar,,,6,115,121,36,0.000012
Floating dongs,,,5,4,9,63,0.000029
Jay Mariotti,,,1,24,25,0,0.000011
No ketchup,,,1,0,1,35,0.000011
Chicago Audrey,,,2,9,11,52,0.000016
Chicago Cubs,,,7,41,48,35,0.000014
Red Sox Nation,,,3,7,10,35,0.000017
Toyota,,,13,21,34,35,0.000044
Chick-Fil-A,,,1,2,3,35,0.000013
Chick Flick,,,5,45,50,39,0.000019
Scott Stapp,,,11,29,40,12,0.000019
Chicken Smoothie,,,7,99,106,31,0.000013
Meisuweasel,,,2,41,43,31,0.000011
Chicken fight,,,1,13,14,38,0.000015
List of Jews in sports,,,2,1,3,15,0.000015
Chickie,,,4,71,75,14,0.000011
Cyberstalking,,,1,0,1,14,0.000011
Chief,,,1,40,41,10,0.000011
Chigger,,,1,2,3,36,0.000011
Chihuahuas,,,4,18,22,25,0.000018
Unseasoned chicken,,,3,6,9,35,0.000023
Culexor,,,16,33,49,48,0.000037
Child Detention Camps,,,0,18,18,17,0.000011
Literally Hitler,,,5,23,28,19,0.000012
Child Modeling,,,7,93,100,43,0.000037
Evil-unveiled.com/Child Modeling,,,1,3,4,43,0.000011
Cock boat,,,16,8,24,10,0.000059
Suri Cruise,,,6,20,26,26,0.00002
Cupcake Thief,,,7,22,29,35,0.00006
Shaycarl,,,14,65,79,48,0.000046
Child welfare,,,5,24,29,35,0.000018
Voluntary Human Extinction Movement,,,5,85,90,2,0.00002
Sam Rassenfoss,,,7,17,24,9,0.000023
Children's Immortality Project,,,1,22,23,10,0.000011
Croatia,,,15,40,55,37,0.000031
Chilean Mole People,,,7,36,43,17,0.000018
Chilf,,,2,16,18,40,0.000011
Chimera Synx,,,3,41,44,31,0.000014
Chimpmania,,,2,30,32,35,0.000013
Nuoh my god,,,13,2,15,46,0.000035
Romance of the Three Kingdoms,,,2,45,47,11,0.000015
China Guy,,,1,126,127,15,0.000015
Death Van,,,2,30,32,11,0.000034
Human flesh search engine,,,1,3,4,11,0.000015
Kazakhstan,,,12,13,25,37,0.000031
What is air,,,4,17,21,9,0.000011
John Cena,,,26,153,179,15,0.000082
Curtis Allgier,,,3,28,31,35,0.000016
FurrMetalAlchemist,,,11,93,104,21,0.000032
TrollsNews,,,2,4,6,15,0.000011
EricDouglace,,,12,123,135,40,0.000022
Jossi,,,8,54,62,2,0.000019
Fasttracker 2,,,2,10,12,40,0.000013
Crabcore,,,8,55,63,12,0.000015
Nerdcore,,,10,70,80,12,0.000023
Nintendocore,,,2,77,79,12,0.00002
Chiu,,,0,2,2,11,0.000011
Chix0r,,,8,37,45,21,0.000018
Lolly,,,18,29,47,21,0.000031
Chloe Dykstra,,,3,5,8,8,0.000011
Plot Bunny,,,2,25,27,32,0.000011
FUNImation2002,,,3,54,57,35,0.000013
Woo Bum-kon,,,7,7,14,58,0.000016
Lucas Caparelli,,,2,28,30,59,0.000015
Ryan Lambourn,,,13,37,50,58,0.00002
Chocobo Nights,,,1,3,4,2,0.000012
Cocoa,,,1,8,9,9,0.000012
Mast Brothers,,,2,12,14,12,0.000013
The Ugly Barnacle,,,7,10,17,34,0.000016
Tim Russert,,,6,27,33,52,0.000052
ChosonNinja,,,3,9,12,49,0.000015
Chris,,,0,28,28,30,0.000011
Christopher Columbus,,,3,25,28,37,0.000015
Christopher Jason Ross,,,1,6,7,41,0.000011
Fatman,,,7,23,30,6,0.000012
Chris-Chan/Wikipasta,,,1,43,44,2,0.000011
Chris-Chan/nav,,,0,20,20,7,0.000011
Chris-chan/Videos,,,3,42,45,38,0.000011
Chris-chan/Chrischangalleries,,,1,64,65,9,0.000011
Chris-chan/Returns,,,1,16,17,19,0.000011
Chris-chan/Vidya Drama,,,1,1,2,7,0.000011
Chris-chan/Places,,,7,51,58,7,0.000019
Chris-chan/ED Christory,,,2,80,82,7,0.000011
Chris-chan/thecrazypacer,,,6,2,8,7,0.000017
Chris-chan/SexScandal1,,,1,6,7,7,0.000011
Chris-chan/SexScandal2,,,5,5,10,7,0.000016
Chris-chan/SexScandal3,,,4,3,7,7,0.000012
Chris-chan/Email Hax,,,1,0,1,7,0.000011
Chris-chan/Trolling,,,3,53,56,32,0.000011
DSM,,,11,20,31,7,0.000027
Doopie DoOver/People,,,9,94,103,53,0.000098
Evan Gragg,,,1,50,51,7,0.000016
Gruntchovski,,,3,9,12,7,0.000018
Laura Kate Dale,,,10,59,69,19,0.000024
LilSoyEvan,,,1,12,13,25,0.000016
Madisonstar Moon,,,1,5,6,51,0.000016
Evil-unveiled.com/Markaba,,,10,5,15,43,0.000034
Timbox,,,10,47,57,7,0.000079
Venom2204,,,4,37,41,7,0.000035
Chris-chan/Annotated,,,0,2,2,7,0.000011
Pogs,,,5,55,60,9,0.000033
Chris-chan/JKH Interview,,,1,42,43,2,0.000011
Parappa The Rapper,,,3,42,45,40,0.000012
Desktop Modding,,,6,58,64,10,0.00002
Shawn Johnson,,,3,52,55,9,0.000037
Rina-Chan,,,11,204,215,57,0.000015
Kids in Sandbox,,,7,8,15,6,0.000038
True love,,,1,0,1,19,0.000011
MySpace Suicide,,,13,10,23,9,0.000028
Gyo Edit,,,14,41,55,9,0.00005
Chris Crocker/I'm a whore because,,,1,2,3,6,0.000014
Dreadnought,,,5,43,48,24,0.000031
Chris Forcand/log1,,,1,3,4,3,0.000013
Chris Forcand/log2,,,1,3,4,3,0.000013
Chris Forcand/log3,,,1,3,4,3,0.000013
Chris Forcand/log4,,,1,3,4,26,0.000013
Chris Forcand/log5,,,1,4,5,3,0.000013
Riverman72,,,4,41,45,43,0.000019
Y'all niggas,,,6,12,18,9,0.000023
Jeremy Hanson,,,4,7,11,2,0.000023
Post-Avant Jazzcore,,,10,3,13,12,0.000016
Equality Profile Pictures,,,20,40,60,59,0.000031
Nickelback,,,20,7,27,12,0.000057
Joshua Idehen,,,7,30,37,19,0.000015
Chrissy Chambers,,,3,3,6,36,0.000015
Holly Jacobs,,,12,8,20,36,0.000041
Christian (disambiguation),,,1,11,12,46,0.000015
Sin,,,16,57,73,46,0.000047
Hebrew,,,12,18,30,37,0.000083
The Way of the Master,,,12,45,57,46,0.000027
Fake Christians,,,2,39,41,46,0.000015
Kerney Thomas,,,4,69,73,36,0.000019
Neal Horsley,,,7,44,51,46,0.000024
RejectedDreams,,,10,146,156,46,0.000031
Lordelthibar,,,14,155,169,7,0.000032
Warren Jeffs,,,4,13,17,35,0.000019
Hutaree,,,3,33,36,9,0.000015
Christian Humber Reloaded,,,2,47,49,28,0.000016
DigitalSurgeon,,,2,16,18,48,0.000012
Christian Boy Love Forum,,,9,21,30,46,0.000015
Christian furry,,,14,22,36,31,0.000074
Christian Teen Forums,,,2,40,42,46,0.000012
Christian Burns,,,0,1,1,53,0.000011
Trigun,,,6,25,31,28,0.000013
Christian Identity,,,1,20,21,46,0.000014
Christianx,,,3,4,7,0,0.000016
Porn Wiki Leaks,,,8,20,28,0,0.000022
Christina Aguilera,,,1,5,6,36,0.000011
Christine O'Donnell,,,7,58,65,14,0.000017
Delaware,,,6,48,54,35,0.000012
Every time you masturbate... God kills a kitten,,,4,20,24,53,0.000019
TyrannoSatan,,,6,26,32,46,0.000024
Jewbo,,,2,6,8,46,0.000026
Digibrony,,,8,108,116,7,0.000018
Christopedia,,,4,15,19,46,0.000017
Christopher Foster,,,2,73,75,48,0.000011
You vs. ED,,,10,9,19,24,0.000026
Christopher Gregorio,,,2,22,24,21,0.000015
Henry Kissinger,,,11,74,85,37,0.000022
Pop Culture,,,17,57,74,12,0.000046
Lolerbation,,,5,6,11,1,0.000013
Chuck,,,2,8,10,43,0.000012
Evil-unveiled.com/Chuck-les,,,1,2,3,43,0.000012
Chuck Dowling,,,4,5,9,8,0.000023
Chuck and Naomi,,,1,31,32,41,0.000012
Chuckle Brothers,,,5,16,21,17,0.000028
Chuckmoulton,,,2,29,31,14,0.000012
Chuckula,,,2,27,29,41,0.000016
Edit,,,9,28,37,10,0.000028
Writing an article for Uncyclopedia,,,4,105,109,13,0.000038
Taxidermy,,,12,10,22,31,0.00002
Pnaomi,,,1,0,1,14,0.000011
Teaching,,,1,0,1,14,0.000011
Chuggaaconroy,,,8,43,51,49,0.000013
Copypasta/Archive 2,,,15,14,29,9,0.000083
Oh god how did this get here I am not good with computer,,,15,3,18,9,0.000034
Chupacabra,,,4,99,103,13,0.000014
Spider expert,,,14,10,24,31,0.000025
Church signs,,,4,2,6,37,0.000014
ChurchOfBlow,,,1,14,15,48,0.000022
TheHill88,,,5,18,23,48,0.000014
Lisanova,,,5,21,26,48,0.000013
Church of Anonymous,,,1,29,30,26,0.000012
Church of Cawd,,,0,1,1,13,0.000011
La Pequeña,,,6,30,36,48,0.00002
Fnord,,,2,2,4,13,0.000012
Ciara,,,1,13,14,36,0.000011
Cid Silverwing,,,12,87,99,31,0.000015
Felinoid,,,6,84,90,31,0.000011
Tamias the Chipmunk,,,12,109,121,31,0.000013
Wolfeedarkfang/supporters,,,5,42,47,31,0.000011
Cid and Conner's Excellent Adventure,,,4,3,7,31,0.000011
Politically incorrect,,,12,19,31,19,0.000026
The LiveJournal Circle Jerk,,,6,14,20,8,0.000024
Soggy biscuits,,,3,7,10,40,0.000018
Evolution Forum,,,4,33,37,31,0.000012
Cirno/Chatlogs,,,1,0,1,28,0.000011
Cisco,,,6,11,17,10,0.000015
Michael Lynn,,,6,11,17,10,0.000016
Ciscogate,,,4,28,32,10,0.000014
Cisco Systems,,,3,14,17,10,0.000013
Drama quotient,,,1,3,4,56,0.000012
Citadel Family Tree,,,2,1,3,55,0.000013
Livy,,,2,54,56,55,0.000013
Mela,,,4,21,25,55,0.000013
Starcade,,,2,7,9,13,0.000013
Great migration,,,1,1,2,55,0.000012
Inara BBS,,,3,21,24,55,0.000013
WikiFUD,,,3,20,23,2,0.000016
City glitter/log,,,1,0,1,25,0.000012
JRanger,,,2,16,18,9,0.000011
Civcraft,,,1,27,28,7,0.000011
Civil Rights,,,2,34,36,14,0.000018
Victoria 2,,,3,34,37,17,0.000014
Cj,,,8,7,15,41,0.000045
Cktraveler,,,2,10,12,18,0.000013
Krokodil,,,6,19,25,13,0.000026
Nuchan,,,5,19,24,52,0.000012
"Claire ""Clairo"" Cottrill",,,0,12,12,19,0.000011
Claire Connelly,,,2,7,9,38,0.000011
Clairemont,,,0,14,14,35,0.000011
Clare Werbeloff,,,5,57,62,23,0.000011
I was there,,,3,14,17,13,0.000014
Clarence,,,12,52,64,34,0.000018
Epic Fat Guy,,,14,20,34,52,0.000044
Clarence/Episode Guide,,,1,166,167,34,0.000011
Luigi's Death Stare,,,6,36,42,49,0.000013
Virtual Boy,,,6,24,30,49,0.000015
Vine,,,21,50,71,17,0.000034
Osomatsu,,,4,2,6,28,0.000011
"Ed, Edd n Eddy",,,9,104,113,36,0.000032
IDGAF,,,4,4,8,58,0.000012
Encyclopedia Dramatica:Advanced Meta,,,2,0,2,9,0.000011
Valerie Plame,,,6,178,184,19,0.000013
Claudia Patricia Gomez Gonzales,,,0,20,20,19,0.000011
Claudy Tu,,,2,8,10,41,0.000011
RMG Productions,,,2,19,21,34,0.000011
TheLittlestJustin,,,1,19,20,7,0.000011
SonofOdin29,,,3,15,18,7,0.000012
Illiniguy34,,,5,6,11,32,0.000033
Clay Duke,,,3,16,19,9,0.000011
Clementine Ford,,,3,10,13,19,0.000017
Clementine Weber,,,6,61,67,27,0.000067
Clementine Weber/Weebly/Chatlog 4 (France),,,1,0,1,27,0.000012
Clementine Weber/Weebly/Chatlog 3 (tax dodging),,,1,0,1,27,0.000012
Clementine Weber/Weebly/Front page,,,1,0,1,27,0.000012
Clementine Weber/Carla Chynoweth/A psychopath's CV,,,1,0,1,27,0.000012
Clementine Weber/Carla Chynoweth/Deptford,,,1,0,1,27,0.000012
Clementine Weber/Carla Chynoweth/The Devil's theologian,,,1,0,1,27,0.000012
Clementine Weber/Carla Chynoweth/Charitable deeds,,,1,1,2,27,0.000012
Clementine Weber/Weebly/Chatlog 8 (David Hodges),,,1,0,1,27,0.000012
Clementine Weber/David Hodges/Liar for hire,,,1,0,1,27,0.000012
Clementine Weber/Weebly/Chatlog 15 (Dancing feminist),,,1,0,1,27,0.000012
Clementine Weber/Jamal Radwan/Eastern promise,,,1,0,1,27,0.000012
Clementine Weber/Weebly/chatlog 1 (Jamal Radwan),,,1,0,1,27,0.000012
Clementine Weber/Weebly/Chatlog 5 (Prince Charles),,,1,0,1,27,0.000012
Clementine Weber/Weebly/Chatlog 2 (Radwan's cookbook),,,1,0,1,27,0.000012
Clementine Weber/Jamal Radwan/Library tour,,,1,0,1,27,0.000012
Clementine Weber/Jamal Radwan/God's Cookbook,,,1,1,2,27,0.000012
Clementine Weber/Weebly/Chatlog 9 (Julian Barnett),,,1,0,1,27,0.000012
Clementine Weber/Weebly/Chatlogs 6 (Lenny Wolfe),,,1,0,1,27,0.000012
Clementine Weber/Weebly/Chatlog 7 (Oded Golan),,,1,0,1,27,0.000012
Clementine Weber/Weebly/Chatlog 6 (Lenny Wolfe),,,0,1,1,27,0.000011
Clementine Weber/Weebly/Chatlogs 4 (Prince Charles),,,0,1,1,27,0.000011
Clementine Weber/Weebly/Chatlogs 6 (Oded Golan),,,0,1,1,27,0.000011
Clementine Weber/Weebly/Chatlogs 6 (Tax dodging),,,0,1,1,27,0.000011
Guatemala Day,,,7,12,19,21,0.00002
Feather niggers,,,1,0,1,35,0.000011
Soy,,,1,0,1,35,0.000011
Catlady,,,1,0,1,35,0.000011
Windsor,,,5,128,133,35,0.000014
Cleveland Steamer,,,8,24,32,39,0.000032
Disputed,,,1,6,7,0,0.000012
Drama remorse,,,4,13,17,8,0.000021
Clever Girl,,,1,4,5,46,0.00002
ClickBangPop,,,5,4,9,52,0.000029
Sony Defense Force,,,15,44,59,49,0.000022
Epic Rap Battles of History,,,5,19,24,12,0.000014
Fail Army,,,3,13,16,32,0.000012
Jacob Sartorius,,,7,53,60,13,0.000016
Lyle McDouchebag,,,2,13,15,52,0.000012
Undertakerfreak1127,,,21,67,88,24,0.000042
Vsauce,,,2,26,28,46,0.000012
Jesus With You Always,,,6,25,31,17,0.000019
Jesus Is Hitler,,,12,31,43,46,0.000052
Rotten Tomatoes,,,15,25,40,32,0.000022
Teens Against Porn,,,5,24,29,31,0.000031
Clicktard,,,2,14,16,10,0.000012
SCO,,,11,24,35,10,0.000025
Esker Melchior,,,2,11,13,10,0.000012
Mustard,,,4,20,24,12,0.000049
NIU Valentine's Day Massacre,,,12,113,125,58,0.000022
David Vitter,,,14,30,44,14,0.000022
Climategate/Leaked Emails,,,1,0,1,46,0.000012
Fourth wall,,,14,46,60,34,0.000107
Megaphone Desktop Tool,,,7,20,27,10,0.000021
Anti porn,,,3,0,3,8,0.000014
Confkids,,,2,3,5,8,0.000013
Thomas Beatie,,,17,29,46,19,0.000031
Cloaking,,,13,21,34,10,0.000047
User-generated content,,,14,42,56,2,0.000045
Clock Crew,,,12,93,105,4,0.000024
Foamy the Squirrel,,,8,33,41,34,0.000017
Tricky the Clown,,,12,38,50,4,0.000023
SchmuckyTheCat,,,9,17,26,2,0.000015
Patachu,,,8,55,63,31,0.000013
CloudNine Multimailer,,,2,1,3,41,0.000016
Cloud Computing,,,1,10,11,10,0.000011
Cloward Piven Strategy,,,4,10,14,17,0.000017
Clown Tobi,,,1,47,48,39,0.000011
The Torture Game,,,1,6,7,49,0.000011
MeToo,,,2,18,20,39,0.000012
IAmTheWalrusWiki,,,2,25,27,10,0.000011
Fire's Forum,,,8,106,114,38,0.000017
Cluttertrap,,,1,5,6,9,0.000022
Trapchan,,,1,0,1,9,0.000014
Frottage,,,18,27,45,39,0.000041
Zone,,,9,60,69,32,0.000014
REV UP THOSE FRYERS,,,9,22,31,9,0.00002
Frank Face,,,8,16,24,34,0.000018
RWBY,,,5,18,23,28,0.000013
Seth Rogen,,,6,5,11,34,0.000037
Nice,,,8,3,11,58,0.000018
Wonder Woman,,,5,30,35,34,0.000015
CoAlpha Reactionary Forum,,,3,39,42,36,0.000013
CoD Fanfiction Wiki,,,0,43,43,21,0.000011
Coaching,,,0,10,10,13,0.000011
Asthma,,,1,0,1,17,0.000011
SIDS,,,3,42,45,1,0.000014
Gorilla199,,,15,54,69,17,0.000049
Iconoclast,,,9,26,35,14,0.000036
King Dedede Drooling While Eating,,,11,8,19,31,0.000034
Maneaeve,,,10,44,54,21,0.000044
Happycock,,,5,17,22,9,0.00003
Bonertron,,,4,0,4,6,0.000027
Goose Cock,,,2,18,20,9,0.000028
Iron penis,,,6,16,22,39,0.000033
Monsquaz,,,1,10,11,4,0.000026
List of Porn Parodies,,,6,29,35,63,0.000059
Why is there a huge cock on the top left corner?,,,5,23,28,4,0.000028
Curb Stomp,,,14,46,60,35,0.000045
Motorboat,,,4,8,12,28,0.000017
Grinface,,,4,3,7,9,0.000029
Raisa Mendoza,,,1,27,28,12,0.000014
Fluffer,,,3,6,9,63,0.000024
Cocoa The Clown,,,3,14,17,8,0.000012
CocoaPuff310,,,2,10,12,24,0.00003
LOLCode,,,2,1,3,10,0.000013
Forth,,,1,9,10,10,0.000012
Dan Brown,,,13,25,38,46,0.000022
Pizza Bomb,,,10,7,17,41,0.000023
Disabled Village Children,,,7,23,30,9,0.000015
Final Fantasy Tactics,,,11,80,91,29,0.000024
CodebreakerDX,,,4,33,37,15,0.000031
Codenamesailorearth/2nd Wikia Saga,,,3,3,6,10,0.000012
Codenamesailorearth/ED Saga,,,3,19,22,36,0.000012
Codenamesailorearth/Galleries,,,1,1,2,10,0.000012
Codenamesailorearth/Nav,,,0,5,5,10,0.000011
Codenamesailorearth/The Beginning,,,3,30,33,2,0.000012
Cody Kardashian,,,1,4,5,50,0.000013
Coelhilth,,,2,25,27,44,0.000011
Coffee--Pot,,,1,29,30,28,0.000011
Coin,,,4,10,14,17,0.000017
Nathaniel Nurnberg,,,3,16,19,39,0.000013
Jew Watch,,,5,15,20,17,0.000026
Coke Music,,,2,14,16,9,0.000012
Cokeman2423,,,3,23,26,58,0.000013
Col Kink,,,1,3,4,34,0.000012
Colby James,,,6,256,262,34,0.00003
The Nutshack,,,8,12,20,11,0.000016
KGB,,,19,6,25,37,0.000024
DATE,,,3,85,88,22,0.000012
Turtles,,,6,7,13,49,0.000014
Colby James/Lovik Bonto Gogenburg,,,1,0,1,34,0.000011
Colby James/Donald Jay Jay French McDonald,,,1,3,4,34,0.000011
Colby James/Tobias Ipswich,,,1,0,1,34,0.000011
Izzy Galvez,,,4,25,29,19,0.000013
KodyBoy555,,,2,26,28,52,0.000013
Leonard F. Shaner Jr.,,,5,49,54,7,0.000013
Lifting Blogs,,,3,24,27,19,0.000011
Colby James/Alpha India,,,1,1,2,34,0.000012
"Colby James/Boomhour ""Boomer"" Ratliff",,,0,16,16,45,0.000011
Colby James/Brook Dario A.K.A James and Katlian Dario A.K.A James,,,1,0,1,45,0.000011
Colby James/CJ2 Troll's Remorse,,,1,0,1,45,0.000011
Colby James/Eric Kriegler,,,1,0,1,45,0.000011
Colby James/Group 57,,,1,0,1,45,0.000011
Colby James/Joseph A.J Pero Brethren,,,1,0,1,45,0.000011
"Colby James/Lewis ""Longshot"" Barker",,,1,0,1,45,0.000011
Colby James/Lily Hesterton,,,1,0,1,45,0.000011
Colby James/MBFW Biography,,,1,3,4,45,0.000011
Colby James/Mighty B! Books written by Colby James,,,1,0,1,45,0.000011
Colby James/Nelsa N. Riggs,,,1,0,1,45,0.000011
Colby James/Roger Joyce Bushell,,,1,0,1,45,0.000011
Colby James/Susanna T. Rosetti,,,1,0,1,45,0.000011
Colby James/Susanne R. Kirshenbaum,,,1,0,1,45,0.000011
Colby James/TMBW Biography,,,1,0,1,45,0.000011
Colby James/TheNick4Guy,,,1,0,1,45,0.000011
Colby James/We Built Millie's Face!,,,1,0,1,45,0.000011
William,,,1,15,16,26,0.000014
Colby James/Kappus Michael Dee Snider Lovell Dario A.K.A James,,,1,2,3,34,0.000012
Driver,,,1,0,1,34,0.000016
Colby James/Nav,,,0,5,5,34,0.000011
Colby James/Bunny Date!,,,1,0,1,34,0.000012
Colby James/The Mighty B! Trust Website,,,1,1,2,34,0.000012
Colby Schoolcraft,,,1,7,8,26,0.000011
Kendrick Moxon,,,6,17,23,26,0.00002
Cold,,,2,10,12,9,0.000013
Colin Kaepernick,,,2,5,7,35,0.000015
Tedjesuschristgod,,,6,10,16,46,0.00002
Kaplan University,,,3,6,9,11,0.000014
Procrastination,,,7,2,9,28,0.000023
Fat Chicks in Party Hats,,,14,32,46,52,0.000036
MIT OpenCourseWare,,,6,33,39,11,0.000017
Jakob Lodwick,,,7,24,31,2,0.000014
WHERE IS THE ARTICLE?,,,3,0,3,2,0.000014
Colonel McBadass,,,2,47,49,7,0.000018
Colonel Meow,,,4,5,9,25,0.000019
Lil Bub,,,4,8,12,25,0.000022
The Giver,,,17,2,19,6,0.000047
Cuddle Party,,,10,6,16,39,0.00003
I'm ok with this,,,4,2,6,9,0.000012
Triggur,,,5,5,10,31,0.000017
YTCracker,,,7,49,56,10,0.000016
Micah Dawson,,,6,60,66,19,0.000025
Userbars,,,1,20,21,11,0.000012
Gay hanky code,,,14,77,91,40,0.000119
Colton Tooley,,,2,24,26,58,0.000015
Valentine,,,8,9,17,58,0.000019
Columbine Gallery,,,2,21,23,58,0.000014
Ryan Schallenberger,,,1,12,13,58,0.000013
Dillon Cossey,,,3,13,16,58,0.000015
ZDaemon,,,6,75,81,32,0.000021
Natural Selection game,,,4,19,23,57,0.000016
Lulzy Mods,,,3,34,37,58,0.000017
Mountain Vista High School,,,4,17,21,58,0.000013
"Don't worry, I'm from the Internet",,,6,7,13,3,0.000035
Dan's Neighborhood,,,5,10,15,37,0.000023
The colonization of America,,,7,41,48,35,0.000024
Combining Cyrillic Millions Sign (Firefox),,,4,11,15,9,0.000012
Cyrillic Millions Sign,,,8,89,97,9,0.000067
Prole,,,1,0,1,17,0.000018
Donnie Davies,,,7,22,29,40,0.000016
Jim Gaffigan,,,4,14,18,9,0.000015
Demetri Martin,,,5,18,23,17,0.000032
ComedyShortsGamer,,,0,21,21,4,0.000011
KSI,,,2,40,42,1,0.000011
Zach Galifianakis,,,1,18,19,37,0.000012
Cometstyles,,,2,23,25,2,0.000011
ComfortablySmug,,,2,6,8,41,0.000013
Wikichan/Ace's Last Moments,,,2,0,2,34,0.000013
Neil Gaiman's Sandman,,,11,86,97,46,0.000055
Jessica Nigri,,,11,19,30,13,0.000051
Reed Barrow,,,1,14,15,7,0.000011
LeonX,,,6,158,164,19,0.000022
SmackJeeves,,,7,111,118,40,0.000016
Peter Principle,,,1,8,9,13,0.000011
Sweet Bro and Hella Jeff,,,14,20,34,1,0.000052
The Gibson,,,15,9,24,10,0.000025
Hello My Future Girlfriend,,,4,14,18,4,0.000015
Icy Hot Stuntaz,,,7,9,16,12,0.000014
IKissYou.org,,,7,28,35,50,0.000027
Max Headroom,,,4,14,18,34,0.000012
David L. Smith,,,2,41,43,10,0.000012
Fry Guy,,,5,60,65,10,0.000021
Jai Maharaj,,,8,5,13,41,0.000018
Jeff Moss,,,3,31,34,10,0.000013
Nicholas Morency,,,4,14,18,41,0.000012
Robert Morris,,,7,39,46,10,0.000012
Schattie,,,2,5,7,41,0.000014
Followup,,,1,9,10,41,0.000011
Hotornot,,,7,18,25,8,0.000021
Joe Cartoon,,,4,10,14,4,0.000014
Open Diary,,,2,32,34,8,0.000011
Telnet,,,7,16,23,10,0.000015
Operation Sundevil,,,5,33,38,10,0.000019
LadyHellFyre,,,8,39,47,21,0.000013
Command & Conquer: Red Alert 2,,,0,3,3,56,0.000011
Command & Conquer,,,1,0,1,56,0.000014
Command line,,,6,20,26,10,0.000027
Commas,,,2,9,11,14,0.000016
Fireuzer,,,4,7,11,8,0.000022
Commission,,,3,19,22,60,0.000011
Common Core,,,2,15,17,19,0.000013
The Areas of My Expertise,,,3,8,11,49,0.000027
Twit,,,6,15,21,55,0.000046
Nathan Satan,,,14,16,30,3,0.000025
Commonwealth,,,16,32,48,37,0.000033
Fiji,,,2,15,17,59,0.000012
Communal journal,,,3,4,7,41,0.000014
Sceneable,,,1,8,9,11,0.000017
Theresa May,,,10,44,54,37,0.000026
DeoTasDevil,,,4,9,13,19,0.000034
Lenincat,,,5,8,13,25,0.000023
Forum Trolling,,,9,53,62,41,0.00002
Homefront,,,3,49,52,14,0.000021
Vocational Independence Program,,,3,52,55,41,0.000018
Russian Army,,,2,35,37,37,0.000014
Supreme Commander,,,4,65,69,49,0.000011
Dwarf Fortress,,,10,51,61,49,0.00002
Shadowgamers,,,6,15,21,21,0.000012
Complete rewrite,,,8,10,18,10,0.000015
Compuserve,,,2,9,11,10,0.000013
MS,,,1,8,9,10,0.000013
Gay bomb,,,10,20,30,40,0.000038
Fdisk,,,3,28,31,10,0.000018
SLI,,,2,15,17,49,0.000016
Troubleshooting,,,1,3,4,23,0.000013
Randy Solem,,,4,25,29,3,0.000016
OpenGL,,,1,11,12,10,0.000013
Nef Quintero,,,3,25,28,10,0.000018
Hack This Site,,,5,43,48,10,0.000023
Jason Aula,,,10,95,105,24,0.000061
Concentricus,,,3,73,76,6,0.000013
Push Butan,,,16,24,40,9,0.000031
Superdemon-Inuyasha,,,13,69,82,21,0.000038
Sollog,,,4,29,33,27,0.000016
Lulznews,,,6,1,7,3,0.000051
I am aware of all internet traditions,,,9,5,14,14,0.000026
Concerned Student 1950,,,2,29,31,35,0.000011
Legacy Computers,,,5,15,20,10,0.00002
Condensation,,,2,4,6,17,0.000019
Dental dam,,,8,21,29,36,0.000021
Oh god what have I done?,,,4,7,11,9,0.00002
Confirm/deny,,,11,14,25,60,0.000035
Congratulations,,,6,8,14,28,0.000026
TooDamnFilthy,,,9,27,36,7,0.000015
Heinrich Himmler,,,5,7,12,37,0.000026
Conner Hemming/story,,,1,2,3,31,0.000011
Draconas Rayne,,,3,40,43,31,0.000011
MrDisambiguation,,,7,27,34,31,0.000012
Repetition,,,7,3,10,49,0.000013
Jesskitt,,,5,45,50,31,0.000028
Connor Cochran,,,1,2,3,0,0.000015
Conquer Online,,,3,45,48,49,0.000012
Consensus,,,6,9,15,2,0.000016
Dakota Fanning,,,10,102,112,36,0.000057
Geo.plrd,,,1,19,20,51,0.000012
Conservapedia/Encyclopedia Dramatica,,,2,19,21,2,0.000012
Flamer,,,17,6,23,41,0.000061
Bias in Wikipedia,,,1,0,1,2,0.000011
Inheritrix,,,3,30,33,8,0.000016
Danny Williams,,,5,13,18,14,0.000014
DonDarkstalker,,,3,13,16,8,0.000013
FacelessMaster3003,,,3,24,27,21,0.000013
Freddie Thompson,,,8,38,46,14,0.000024
George Allen,,,7,13,20,35,0.000019
Iain Hall,,,10,33,43,59,0.000036
Ian Schwartz,,,4,16,20,14,0.000024
Imaybeparanoid,,,7,7,14,8,0.000019
Jane Cunningham,,,3,18,21,53,0.000013
Jeff Gannon,,,9,26,35,14,0.000017
John Howard,,,17,53,70,14,0.000033
Johnny Rebel,,,8,11,19,35,0.000018
Lindsey Graham,,,5,21,26,14,0.000018
Mike Crapo,,,2,17,19,46,0.000013
Mikhail Saakashvili,,,9,46,55,32,0.000032
Norm Coleman,,,4,32,36,14,0.000019
Patrick McHenry,,,8,19,27,14,0.000026
Paul Wolfowitz,,,5,22,27,14,0.000019
Ray McBerry,,,6,91,97,14,0.000018
Richard Curtis,,,9,21,30,40,0.000022
Rob Ford,,,9,21,30,14,0.000039
Scott Bibby,,,4,17,21,2,0.000013
Stephen Harper,,,5,18,23,14,0.000016
Trent Lott,,,6,16,22,14,0.000016
Werechu,,,12,52,64,31,0.00002
Xiao-Feng-Fury,,,12,43,55,46,0.000021
Final Fantasy XIII,,,11,219,230,29,0.000019
Occam's Razor,,,8,9,17,46,0.000036
Heppum's Razor,,,2,6,8,3,0.000056
Godlike Productions,,,5,15,20,17,0.000016
Montagraph,,,6,50,56,17,0.000024
Context,,,5,6,11,8,0.000015
Furvert,,,15,12,27,31,0.000021
Public e-stonings,,,3,9,12,3,0.000026
Furry love,,,1,0,1,31,0.000012
Parents for the Online Safety of Children,,,6,15,21,31,0.000029
Kitsune Youkai,,,4,80,84,31,0.000015
Triciakitty,,,10,61,71,48,0.000021
Internet crush,,,11,17,28,8,0.000013
Soshesays,,,2,40,42,8,0.000013
Sextips,,,7,12,19,8,0.000016
Generic Article,,,4,17,21,2,0.000014
"Control, alt, delete",,,2,16,18,10,0.000013
JeremyJX,,,9,9,18,8,0.000046
Dashcon,,,12,64,76,39,0.000024
Cookie Clicker,,,5,2,7,17,0.000014
Cookie cutter,,,1,15,16,12,0.000012
Simple English,,,8,17,25,57,0.000058
Cooking Party,,,2,11,13,39,0.000064
Cooking With Jack Show,,,1,11,12,34,0.000011
Cooks Source,,,1,10,11,16,0.000011
Cool3,,,1,18,19,2,0.000011
MZMcBride,,,9,27,36,2,0.000026
YourMovieSucksDOTorg,,,6,19,25,46,0.000016
Cool Guy,,,0,2,2,61,0.000011
Cool your jets,,,3,16,19,9,0.000011
Problematic,,,11,19,30,19,0.000018
Coolguy2,,,2,5,7,35,0.000014
Coolzafara96,,,0,30,30,7,0.000011
Nascar221,,,9,45,54,7,0.000023
Cooper Lawrence,,,3,21,24,49,0.000016
Tylor King,,,5,25,30,26,0.000017
Ravpup,,,3,6,9,59,0.000016
Copypasta/Archive 1,,,14,16,30,9,0.000082
Copypasta/Archive 3,,,14,18,32,9,0.000083
Copypasta/Archive 4,,,15,13,28,9,0.000083
Copypasta/Archive 5,,,14,15,29,9,0.000082
Copypasta/Archive 7,,,15,26,41,9,0.000089
Copypasta/Archive 8,,,16,12,28,9,0.00016
Copypasta/Archive 9,,,14,19,33,9,0.000083
Copypasta/Archive 10,,,14,11,25,9,0.00008
Copypasta/Archive 11,,,14,13,27,9,0.000085
Copypasta/Archive 12,,,14,15,29,9,0.000084
Wikichan/A Collection Of Incest Confessions,,,3,3,6,9,0.000048
Josef Fritzl copypasta,,,3,16,19,9,0.000027
My Sister is a Dickgirl,,,3,4,7,22,0.000031
Oldest Copypasta,,,3,1,4,9,0.000024
Tramp Anon,,,2,7,9,9,0.000028
Reddit/Reddit Copypasta,,,3,3,6,59,0.000025
Nerd Rage/Callout,,,2,42,44,26,0.000015
Corey Margera,,,3,127,130,49,0.00003
Speakonia,,,8,5,13,4,0.000015
Toowoomba,,,5,78,83,35,0.000016
Sarah Ruscoe,,,3,28,31,36,0.000012
Corn,,,5,5,10,12,0.000013
Daniel,,,7,27,34,52,0.000025
Green Onions,,,4,12,16,12,0.000015
Cornell University,,,3,20,23,11,0.000013
Ezra Hub,,,1,66,67,9,0.000011
Corrupt.org,,,1,40,41,51,0.000011
Electronic Frontier Foundation,,,13,16,29,10,0.00002
Mike Godwin,,,5,16,21,2,0.000019
Guy IRL,,,3,21,24,4,0.000012
Cory Gough,,,2,38,40,0,0.000014
Cory Kennedy,,,4,15,19,36,0.000015
CosmicJohn CL Experiment,,,8,26,34,41,0.000012
Cosmo,,,1,11,12,35,0.000011
MagMyPic,,,7,36,43,9,0.000019
David Futrelle,,,7,117,124,19,0.000013
The Witcher,,,8,64,72,50,0.000021
"Joel ""Inciter"" Ivory",,,1,20,21,39,0.000014
Krisez,,,3,25,28,28,0.000015
Saeto,,,3,15,18,8,0.000014
JournalFen,,,5,5,10,8,0.00002
Air conditioning,,,1,0,1,48,0.000016
The Dickriders,,,11,34,45,46,0.00002
Coughlan666/Relationship and Downfall,,,0,51,51,15,0.000011
Mic spamming,,,8,39,47,49,0.000013
Sig,,,3,58,61,5,0.000012
Crossfire,,,5,97,102,37,0.000012
Gamer Countries,,,1,22,23,37,0.000012
Countervandalism.org,,,1,13,14,2,0.000011
Category:Templates,,,6,0,6,62,0.000012
Courtney,,,0,3,3,37,0.000011
Courtney Stodden,,,2,3,5,36,0.000014
Covini C6W,,,5,9,14,9,0.000011
Cow/,,,0,83,83,7,0.000011
Lolcow.farm,,,9,27,36,19,0.000019
Space Dandy,,,3,30,33,28,0.000012
Cowkitty,,,5,41,46,19,0.000012
Geekgirl,,,3,13,16,10,0.000012
Cowman109,,,5,34,39,2,0.000011
Cpedia,,,2,14,16,2,0.000016
Thick Skin,,,11,49,60,41,0.000021
Crabchan,,,4,2,6,49,0.000012
Morbid Krabs,,,9,16,25,34,0.000066
Crab Nicholson: Extreme Sleepover,,,2,15,17,49,0.000014
DJ Tiesto,,,4,23,27,34,0.000015
Crack Ship,,,4,8,12,28,0.000012
Gay.com,,,7,31,38,40,0.000017
White Nerd's Burden,,,3,6,9,19,0.000028
Jeff Dunham,,,10,46,56,61,0.000028
Riverbaby,,,1,12,13,36,0.000015
Heather Mills,,,4,17,21,10,0.000017
Up-Chan,,,3,23,26,9,0.000013
Crackyhouse,,,4,20,24,22,0.000012
Craig Brittain,,,1,26,27,19,0.000011
Internet Politics,,,8,65,73,14,0.000023
Michael John Anderson,,,4,22,26,41,0.000019
Craigslist Killer,,,1,3,4,41,0.000014
"Met Him/Her On Craigslist, Is This Win?",,,1,10,11,9,0.000014
Craigslist Romantic Forums,,,3,49,52,41,0.000014
Craigslist/Forums,,,1,61,62,54,0.000011
Parakeet,,,1,2,3,10,0.000026
Ruby on Rails,,,13,26,39,10,0.000036
Undefined,,,1,1,2,10,0.000016
Crazedg,,,0,15,15,21,0.000011
Crazy Dad,,,4,4,8,9,0.000028
Crazy Gideon,,,2,25,27,10,0.000011
Geek Squad,,,13,102,115,18,0.000024
Crazyconan,,,3,7,10,40,0.00002
Crazyvideosandrants,,,1,45,46,11,0.000011
Memy9909,,,7,22,29,7,0.000013
EditThis.info,,,4,8,12,2,0.000012
Crocoduck,,,7,18,25,46,0.000019
Trailer Park Boys,,,12,12,24,34,0.000021
ObjectiveMinistries,,,4,36,40,46,0.000015
Stormy,,,9,44,53,8,0.000027
Hyperbolimia,,,2,7,9,14,0.000012
Creepypasta/Awesome Creepypasta,,,2,1,3,22,0.000014
Creepypasta/Mediocre Creepypasta,,,3,3,6,9,0.000018
Creepypasta/Lengthy Creepypasta,,,3,2,5,22,0.000015
Creepypasta/The Gallery of Henri Beauchamp,,,1,9,10,5,0.000014
Creepypasta/The Holders,,,2,20,22,9,0.000014
Creepypasta/Mirrors and Creepypasta,,,2,1,3,22,0.000014
Creepypasta/Video Games and Creepypasta,,,3,15,18,7,0.000015
Creepypasta/Paranormal Creepypasta,,,4,2,6,9,0.000015
Creepypasta/Russia spoofs,,,1,0,1,22,0.000014
Creepypasta/Survival Guide,,,2,8,10,9,0.000014
Creepypasta Narrators,,,1,3,4,22,0.000014
Dead Can Man,,,1,3,4,22,0.000014
It's slowly coming this way!,,,12,29,41,9,0.000022
Hypno,,,6,32,38,17,0.000028
The Holders,,,5,26,31,5,0.000018
Monsters By State,,,8,77,85,46,0.000031
FanFiction/Midnight in the Morgue,,,2,0,2,22,0.000018
Don't Hug Me I'm Scared,,,4,74,78,34,0.000019
Creepypasta/Humper-Monkey's Ghost Story,,,0,5,5,22,0.000011
Creepypasta/TheOtherkin,,,1,4,5,22,0.000017
Scared kitty,,,7,6,13,9,0.000014
Mrcreepypasta,,,1,22,23,19,0.000015
Creepypastajack,,,1,11,12,39,0.000015
The Geterator,,,6,12,18,32,0.000016
Message from Scientology,,,4,22,26,26,0.000014
Enjoy your time protesting,,,2,8,10,35,0.000014
Trumi,,,4,50,54,21,0.000013
Draco Ookami,,,7,55,62,12,0.000014
Crimson-Silvrblood/Chatlogs,,,1,1,2,21,0.000011
Zeartist,,,5,171,176,34,0.000013
Suzi Blu,,,3,60,63,39,0.000032
CrimsonNightshade,,,1,55,56,53,0.000012
Hover hand,,,13,51,64,39,0.000033
Plastic Surgery,,,10,28,38,19,0.000023
LiveJournal Roleplay,,,9,60,69,8,0.000021
Public Access,,,3,38,41,32,0.000015
Factitious disorder,,,1,11,12,7,0.000011
Dcrisisbeta,,,3,14,17,22,0.000012
Lollerskates,,,22,11,33,48,0.000148
Lanaia Lee,,,3,5,8,41,0.000016
Street soldier,,,9,27,36,35,0.000022
Critics United,,,2,36,38,28,0.000011
SailorMercury90,,,12,106,118,28,0.000022
Limit break,,,9,11,20,36,0.00007
Lando,,,5,46,51,31,0.000017
Remove Kebab,,,3,4,7,37,0.000013
Slovenia,,,5,22,27,37,0.000022
Crockpotso,,,0,7,7,24,0.000011
PixelArtGalore,,,1,32,33,7,0.000012
Crocodile,,,2,2,4,13,0.000011
Cropperb,,,5,51,56,40,0.000013
Cross Ange,,,1,8,9,28,0.000011
Cross Country,,,1,11,12,35,0.000013
Xfire,,,6,26,32,3,0.000013
Them,,,6,6,12,13,0.000023
Crossmack/Chat logs,,,1,1,2,48,0.000012
Hyperreal,,,2,26,28,31,0.000012
Marvel vs Capcom 3,,,8,57,65,36,0.000024
Pooh's Adventures,,,11,25,36,34,0.000029
Crowdleaks,,,1,16,17,10,0.000012
Reason,,,10,15,25,12,0.000018
Sunderedmoon,,,7,59,66,24,0.000017
Mix Hyena,,,5,17,22,31,0.000014
Kindrift,,,4,22,26,31,0.000011
Postfurry,,,6,16,22,31,0.000016
Cry of Fear,,,3,38,41,7,0.000012
Modding,,,15,30,45,49,0.00002
Love You Forever,,,7,12,19,9,0.000054
Dr4g0nK1d,,,4,60,64,26,0.000014
Cryptocurrency,,,0,4,4,17,0.000011
Cryptome,,,7,18,25,10,0.000014
Far Cry,,,10,19,29,49,0.000016
Crysis 2,,,4,38,42,49,0.000012
Crysis 3,,,1,14,15,49,0.000011
Crystal-For-Ever,,,8,53,61,21,0.000019
RougeFury,,,3,18,21,21,0.000011
Princessangel83,,,8,79,87,21,0.000013
Sheila Bowers,,,1,20,21,12,0.000011
Crystal Chappell,,,3,9,12,36,0.000012
Face of the Future,,,7,109,116,9,0.000017
Minimum wage,,,1,0,1,2,0.000011
Crzrussian,,,1,3,4,37,0.000011
Cs-chan,,,1,64,65,21,0.000011
Paul the Psychic Octopus,,,15,52,67,9,0.000025
Cthulu,,,1,0,1,46,0.000015
Sora Del Corazon,,,3,63,66,34,0.000014
Cuban Missile Crisis,,,6,15,21,35,0.000023
Cubby,,,2,26,28,52,0.000011
Cuddlepaws,,,0,13,13,31,0.000011
Skrat,,,11,54,65,31,0.000017
Telephone Ring Ring,,,7,34,41,31,0.000014
Ludalaluna,,,2,23,25,31,0.000011
Culexor/YouTube,,,2,3,5,48,0.000012
Jwriter4,,,3,49,52,48,0.000021
Life Coach,,,2,8,10,46,0.000017
Putrid sex object,,,2,18,20,6,0.000013
WIRED,,,4,26,30,4,0.000024
Russell Greer,,,4,29,33,7,0.000015
Cultural cringe,,,1,16,17,35,0.000013
Profile,,,4,11,15,39,0.000016
Defending the Truth,,,3,12,15,14,0.000012
Jessica Valenti,,,11,29,40,39,0.000061
CuntFace,,,1,9,10,22,0.000012
CuntFuckBitch,,,3,15,18,48,0.000014
Cunt Destroyer,,,1,5,6,0,0.000015
Cupcake,,,0,4,4,9,0.000011
Cupcakes,,,6,28,34,7,0.000017
Self Defense,,,1,32,33,35,0.000013
Reitanna-Seishin,,,5,28,33,7,0.000013
Teeth,,,5,7,12,48,0.000015
Curly,,,3,10,13,39,0.000011
SPUI,,,2,5,7,2,0.000012
Internet Mascot Heaven,,,5,14,19,9,0.000014
Curtis,,,2,4,6,43,0.000012
Curtis Got Slapped By A White Teacher!,,,11,30,41,35,0.000023
Evil-unveiled.com/Curtis,,,1,4,5,43,0.000013
MetaFilter,,,10,123,133,19,0.00002
Lance Carsello,,,2,31,33,0,0.000012
Curvy,,,2,25,27,52,0.000031
Fat shaming,,,6,14,20,52,0.000035
Fat Princess,,,6,22,28,52,0.000037
Garden Thief,,,7,56,63,35,0.000043
Customers suck,,,8,25,33,8,0.000016
Grove,,,6,14,20,41,0.000019
Cute Overload,,,4,26,30,8,0.000026
Cutechong,,,6,91,97,24,0.000011
Drama War,,,4,26,30,1,0.00004
Tiago-photo,,,5,55,60,24,0.000017
Cutefuzzypuppy,,,3,3,6,23,0.000017
Cwilliams1976,,,1,1,2,34,0.000011
Cyanterrorist,,,11,38,49,48,0.000014
CyberArmy,,,1,21,22,10,0.000016
ED Porn Challenge,,,6,36,42,6,0.000032
CyberDefender,,,2,17,19,10,0.000016
"It's not a bug, it's a feature",,,21,30,51,10,0.000038
CyberDefender/Wikipedia,,,1,6,7,10,0.000011
Computer virus,,,1,0,1,10,0.000012
Rogue security software,,,1,0,1,10,0.000012
Class action lawsuit,,,1,0,1,10,0.000012
LUE,,,14,46,60,3,0.000061
Conformist,,,1,0,1,41,0.000013
Cyberbunny,,,1,18,19,53,0.000011
Pedophile Hunter,,,5,12,17,41,0.000012
Khimeros,,,5,66,71,54,0.000011
PsyPets,,,3,22,25,38,0.000011
Rikopets,,,6,22,28,38,0.000011
Mudsex,,,5,11,16,31,0.000024
Cyberwarfare,,,3,36,39,14,0.000012
Madagascar,,,13,28,41,35,0.000018
Jew Lieberman,,,15,29,44,14,0.000051
Estonian cyberwar,,,3,128,131,10,0.000011
Stuxnet,,,6,22,28,17,0.000021
Victor Lewis-Smith,,,7,5,12,41,0.000016
Cylon,,,1,7,8,33,0.000013
Scientology Agents,,,7,62,69,26,0.000018
Wikigroaning,,,13,39,52,2,0.000028
Cyndre/Chatlog,,,1,2,3,41,0.000011
Cyndre/Chat logs,,,1,0,1,48,0.000011
Cyndre/MySpace Adventure,,,9,20,29,48,0.000017
MySpace Adventure,,,6,15,21,51,0.000013
Dangerdan/MySpace Adventure,,,4,19,23,48,0.000015
Michael Karolchyk,,,6,29,35,52,0.000014
Cyndre/snuva-rant,,,0,1,1,48,0.000011
Cynthia,,,9,66,75,49,0.000027
Cynthia McKinney,,,5,35,40,14,0.000013
Uncut diamond,,,2,13,15,8,0.000012
Women's rights,,,6,20,26,39,0.00002
Flannery,,,2,54,56,38,0.000014
Garchomp,,,6,54,60,15,0.000013
Cyprus,,,9,28,37,37,0.000018
Nick Clegg,,,12,52,64,37,0.000022
Lockerz.com,,,6,28,34,9,0.000014
Drama Prairie Dog,,,8,16,24,9,0.000014
Hai guy,,,6,5,11,9,0.000014
Post in this thread if (x),,,4,11,15,9,0.000013
Isn't Dallas in California?,,,5,12,17,9,0.000014
Jack Spicer,,,19,19,38,9,0.000028
Mexi-chan,,,9,28,37,9,0.000017
Final Fantasy X,,,8,49,57,29,0.000017
Slossle,,,13,2,15,48,0.000027
D-malice/Logs,,,1,11,12,52,0.000011
Final Fantasy Disease,,,4,6,10,28,0.000019
Xenogears,,,6,70,76,28,0.000012
Dance In The Vampire Bund,,,10,50,60,28,0.000017
Postvixen,,,5,12,17,31,0.000019
D8,,,3,9,12,41,0.000017
DA--stamps,,,1,27,28,21,0.000011
J.K. Rowling,,,10,63,73,19,0.000017
DALnet,,,3,16,19,41,0.000014
Netflix and chill,,,10,38,48,19,0.000015
Dead Space,,,9,173,182,22,0.000017
SCP Foundation,,,2,20,22,19,0.000011
Ponos,,,1,0,1,22,0.000011
DA World Tour 2009,,,2,20,22,21,0.000015
Jark,,,16,45,61,21,0.000029
DBI,,,0,4,4,50,0.000011
DBZ Tribute,,,2,67,69,49,0.000011
Sketch Dalmatian,,,6,47,53,21,0.000012
EdenHeroineGirl,,,3,62,65,28,0.000011
Evil-unveiled.com/Rookiee,,,29,3,32,43,0.000231
Daniel Cicciaro,,,4,39,43,35,0.000017
David Cerny,,,6,73,79,37,0.000021
Dildo Chicken,,,4,11,15,41,0.000012
Dodge Cat,,,6,33,39,9,0.00002
Drawn-chan,,,3,39,42,9,0.000012
DCC SEND startkeylogger 0 0 0,,,4,7,11,41,0.000012
Frets On Fire,,,4,68,72,0,0.000012
NGO,,,3,8,11,15,0.000011
Therealagerbon,,,9,31,40,48,0.000017
Yaminoeyes,,,5,44,49,21,0.000013
DERPTrolling,,,4,7,11,10,0.000011
Ruby Dragon Entertainment,,,6,116,122,29,0.000014
VinceintheBay,,,9,34,43,10,0.000023
DEUUEAUGH,,,4,27,31,34,0.000018
DFC,,,2,4,6,28,0.000011
The Family Circus,,,7,24,31,61,0.000024
OtherKinDating,,,3,6,9,31,0.000011
DILDOlover,,,3,19,22,26,0.000019
DeAndre Harris,,,4,27,31,35,0.000015
DeadJournal,,,10,8,18,8,0.000028
DJ-Leorina,,,5,94,99,21,0.00002
DJ-Leorina/Email log,,,1,1,2,21,0.000011
DJRaziel,,,2,59,61,47,0.000011
Derpaviangott,,,4,40,44,47,0.000012
Legacy of Kain,,,8,94,102,47,0.000019
Fluffers,,,1,0,1,1,0.000011
Hive mind,,,1,0,1,1,0.000011
IDubbbzTV,,,11,45,56,7,0.000019
Pyrocynical,,,5,26,31,42,0.000013
GradeAUnderA,,,7,53,60,1,0.000015
Jammno,,,3,9,12,8,0.000015
DJ SkeptiK/Chatlog,,,2,1,3,22,0.000011
DJ SkeptiK/Chat logs,,,2,1,3,8,0.000011
Tegan and Sara,,,3,48,51,40,0.000011
DLAbaoaqu,,,2,37,39,61,0.000011
Geerup,,,16,25,41,46,0.000031
US Copyright Group,,,5,20,25,10,0.000017
QWERTY,,,5,5,10,53,0.000021
User:Patty,,,2,0,2,54,0.000024
Tmbg37,,,2,1,3,54,0.000024
DNS Comic/Original,,,1,0,1,54,0.000018
DOS game,,,3,36,39,49,0.000012
Mouseboy,,,8,20,28,9,0.00002
Speed Nigger,,,2,0,2,35,0.000013
X of dicks,,,3,22,25,9,0.000014
DRAGOTH BELMONT,,,0,10,10,58,0.000011
LiveWire,,,3,171,174,32,0.000021
DTV Forum,,,2,25,27,16,0.000013
Middle Ages,,,4,23,27,37,0.000012
Giga Pudding,,,9,64,73,9,0.000022
DWG,,,1,35,36,31,0.000011
DaHaloChick,,,5,56,61,52,0.000013
Show everyone online that i did,,,1,0,1,52,0.000011
Dessert,,,1,0,1,52,0.000011
Weight,,,1,0,1,52,0.000011
Eaten,,,1,0,1,52,0.000011
Fatten,,,1,0,1,52,0.000011
Dinner,,,1,0,1,52,0.000011
Da MySpace Niggaz,,,1,8,9,41,0.000011
Dad's dog's leg,,,2,8,10,41,0.000011
Dada,,,2,3,5,37,0.000013
Emodad,,,3,7,10,9,0.000027
Daedalus The Dopefish,,,1,68,69,31,0.000027
HNNO,,,4,66,70,31,0.000012
Little Green Footballs,,,6,23,29,14,0.000015
Trash Dove,,,8,19,27,19,0.000023
Dakari-King Mykan,,,6,126,132,61,0.000014
Dakota,,,0,9,9,36,0.000011
North Dakota,,,10,61,71,35,0.000016
Young men,,,1,0,1,31,0.000012
Kibble,,,2,37,39,31,0.000012
Dalhusky,,,21,82,103,31,0.000032
Kobidobidog,,,9,63,72,31,0.000014
Miaarose,,,6,39,45,48,0.000013
Kimberleigh,,,7,21,28,48,0.000014
MysteryGuitarMan,,,8,14,22,48,0.000016
Damien Zygote,,,2,2,4,35,0.000012
Fox Azure,,,2,20,22,35,0.000016
Dan's Devil's Dictionary,,,1,6,7,52,0.000011
Dumuzi-ouji,,,7,44,51,7,0.000015
Dan Arel,,,0,4,4,39,0.000011
Dan Bailey,,,3,72,75,14,0.000012
Dan Lirette/FUCK YOU,,,1,1,2,36,0.000011
Dan Lirette/ZoSo,,,2,0,2,36,0.00002
It Gets Better,,,5,29,34,40,0.000034
Dana DeArmond,,,1,1,2,0,0.000012
Imagec0rrupt3d,,,4,98,102,21,0.000011
Dancing Owen,,,11,25,36,4,0.000023
The Kadaitcha Dancers,,,14,8,22,31,0.000043
Mosh Girl,,,6,6,12,9,0.000026
"Harder, Better, Faster, Stronger",,,16,25,41,12,0.00005
Jarhead,,,1,0,1,33,0.000011
Entertainment,,,6,4,10,8,0.000021
DandCVideos,,,6,39,45,48,0.000015
Thewinekone,,,3,12,15,48,0.000012
VoicEverything,,,5,34,39,26,0.000011
Larry the Cable Guy,,,8,36,44,35,0.000024
Dangasm/Logs,,,1,3,4,8,0.000011
Dangerdan/Chat logs,,,1,0,1,48,0.000013
Longcat flooder,,,1,0,1,10,0.000017
Rok/i/ts,,,2,1,3,10,0.000023
Drug-addled Yenta,,,4,17,21,27,0.000012
Jenn Pisstler,,,10,33,43,52,0.000015
Daniel J. Bernstein,,,4,12,16,10,0.000013
Evil-unveiled.com/Turtle-guy,,,4,2,6,43,0.000025
Daniel Iskandar,,,3,20,23,63,0.000016
Daniel Kay,,,2,30,32,31,0.000011
Daniel Llamas,,,4,14,18,31,0.000012
Evil-unveiled.com/Michel122002,,,6,10,16,43,0.000041
Wikipedia Review/I'm researching Encyclopedia Dramatica/Page 1,,,4,0,4,2,0.000017
Wikipedia Review/I'm researching Encyclopedia Dramatica/Page 2,,,4,0,4,2,0.000017
Wikipedia Review/Move the Encyclopedia Dramatica thread back,,,3,0,3,2,0.000013
Wikipedia Review/Brandt vs. Michael Suarez,,,2,0,2,2,0.000013
Proabivouac,,,7,34,41,2,0.000017
Daniel Frisiello,,,3,14,17,19,0.000015
Trump Tower Climber,,,2,5,7,19,0.000015
Kibo,,,3,7,10,40,0.000023
Cub porn,,,1,0,1,31,0.000011
Daniel Myers,,,1,15,16,12,0.000011
Daniel P. Lyons,,,0,1,1,21,0.000011
Signaling,,,6,34,40,19,0.000014
Tooner14,,,3,35,38,7,0.000011
Paul Franke,,,7,38,45,53,0.000021
Daniellehedgehog,,,4,37,41,21,0.000013
Danish,,,12,8,20,37,0.000052
Danni Ashe,,,3,25,28,3,0.000014
Danny Dunagin,,,2,8,10,26,0.000011
Danny Elfman,,,1,13,14,53,0.000023
Danny Fratella,,,0,13,13,58,0.000011
Danny Masterson,,,3,13,16,26,0.000017
Veropedia,,,5,21,26,2,0.000013
Danskunk,,,1,18,19,31,0.000011
Toronto-Furry,,,7,28,35,31,0.000012
E-stalking,,,1,0,1,31,0.000011
Furmeet,,,13,18,31,31,0.000018
Danzxoxox,,,3,17,20,41,0.000013
Danzyboy,,,4,16,20,9,0.000011
Daring Do Book Series,,,3,19,22,9,0.000012
Darius McCollum,,,0,8,8,35,0.000011
DarkNekogami,,,3,34,37,21,0.000011
DarkSydePhil/2016,,,0,30,30,17,0.000011
DarkSydePhil/Fantards,,,1,6,7,19,0.000011
DarkSydePhil/Girlfriend,,,2,10,12,27,0.000013
Dark Souls 3,,,1,6,7,49,0.000012
Darkfall,,,19,97,116,49,0.000063
Ragdoll Physics,,,9,16,25,49,0.000016
Darkfolf,,,3,40,43,31,0.000012
Hardstylenno,,,3,53,56,31,0.000011
Ebon Lupus,,,5,80,85,31,0.000014
Darkness,,,2,3,5,42,0.000012
World of Darkness,,,5,51,56,15,0.000015
Gay kiss,,,6,13,19,48,0.000024
Buddy,,,1,0,1,24,0.000011
Darkorion69,,,5,102,107,6,0.000013
Nuts,,,7,5,12,1,0.000017
Spokane,,,4,35,39,37,0.000013
Forthcoming shitstorms,,,1,17,18,63,0.000011
WingsofRedemption,,,2,17,19,7,0.000014
Purity sin,,,1,15,16,7,0.000011
"DarksydePhil/DSP the ""Average Gamer"" or ""The hateful dissection of DSP's mentality""",,,0,2,2,19,0.000011
DarksydePhil/PCgaming,,,0,3,3,49,0.000011
Watch Dogs,,,6,86,92,49,0.000017
Darkzero63,,,3,11,14,48,0.000011
Darl McBride,,,2,8,10,10,0.000013
Pamela Jones,,,3,14,17,10,0.000016
Project Monterrey,,,2,7,9,10,0.000013
Darlie Brewster,,,1,4,5,53,0.000015
Darling in the FranXX,,,0,33,33,28,0.000011
Elfen Lied,,,2,29,31,28,0.000011
Darr,,,9,61,70,26,0.000023
Darr/Arbchat,,,1,5,6,57,0.000011
Diamond Anastasia,,,4,34,38,26,0.000017
L0pht,,,1,9,10,57,0.000012
Darrentmail,,,6,20,26,44,0.000012
Duck Hunt,,,8,50,58,49,0.000019
Darviela Maravarona/Chatlogs,,,1,2,3,6,0.000012
Darviela Maravarona/Lol logs,,,1,19,20,24,0.000012
Worldstar Hiphop,,,4,7,11,35,0.00002
Timothy Treadwell,,,3,26,29,40,0.000014
Fyre Festival,,,2,7,9,19,0.000011
DashieGames,,,2,10,12,61,0.000012
Date Rape,,,0,24,24,39,0.000011
File:Hello.jpg,,,4,0,4,19,0.000012
Umineko,,,5,29,34,28,0.000013
Dave,,,2,16,18,17,0.000013
Intervocalic,,,3,12,15,8,0.000012
Evil-unveiled.com/Fatrat,,,1,3,4,43,0.000011
Dave Henry,,,4,7,11,46,0.000013
Dave Eggers/Control,,,2,13,15,41,0.000012
Search engine,,,9,15,24,10,0.00002
Everyone dies,,,7,14,21,46,0.000018
Dave Reynolds,,,0,30,30,31,0.000011
Evil-unveiled.com/Zanthalon,,,21,2,23,43,0.000064
David Raymond Amos,,,1,9,10,41,0.000012
David Duchovny,,,5,20,25,26,0.000016
David Gray,,,3,27,30,58,0.000013
Evil-unveiled.com/JustaDadatHome,,,4,6,10,43,0.000017
Kate Leth,,,3,26,29,19,0.000012
David Buckel,,,0,32,32,19,0.000011
John Major,,,8,20,28,17,0.000017
William Hague,,,6,19,25,17,0.000015
Jason Beghe,,,9,15,24,26,0.000028
Oldnataliedee,,,6,20,26,48,0.000017
Pinterest,,,4,20,24,39,0.00002
SJWiki,,,10,48,58,19,0.000019
David G. Ludwig,,,1,17,18,1,0.000011
WKD,,,7,16,23,2,0.000019
MST,,,5,38,43,61,0.000015
Eduard Khil,,,11,31,42,9,0.000023
IRL meme,,,8,37,45,9,0.000036
David Hockey,,,15,212,227,50,0.000018
Godmoding,,,6,20,26,8,0.000012
Ladder Theory,,,11,47,58,36,0.000027
Niggercock,,,9,18,27,63,0.000024
Pit Viper,,,11,142,153,50,0.000015
Wellaware1.com,,,4,25,29,17,0.000011
Shot,,,2,7,9,20,0.000013
Jim Davidson,,,10,59,69,17,0.00003
Mike Corley,,,2,1,3,17,0.000012
David Irving,,,0,3,3,17,0.000011
David Kalac,,,0,6,6,9,0.000011
David Kitchen,,,0,9,9,40,0.000011
Terryeo,,,7,23,30,26,0.000015
Jenna Miscavige Hill,,,1,3,4,26,0.000012
David Ritcheson,,,0,12,12,35,0.000011
Steve Shives,,,5,4,9,19,0.000014
David Wolfe,,,1,20,21,38,0.000011
The raw food movement,,,5,64,69,38,0.000013
David Wu-Kapauw,,,3,6,9,26,0.000011
Hyves,,,2,11,13,6,0.000012
Valleyfever,,,3,55,58,48,0.000011
Legendary ruin status,,,12,93,105,41,0.000019
Reupload,,,5,24,29,48,0.000014
Daviswiki,,,3,9,12,5,0.000013
SaulSugerman,,,2,6,8,5,0.000013
Davkal,,,2,14,16,2,0.00002
ScienceApologist,,,4,36,40,2,0.00002
GreenTeaGirlie,,,9,33,42,48,0.000018
Day of Silence,,,3,30,33,40,0.000011
Day of the Ninja,,,1,5,6,19,0.000013
Dayna,,,3,25,28,52,0.000011
Dboots,,,1,2,3,30,0.000015
Dbootsthediva,,,4,7,11,48,0.000012
Dcigs,,,7,69,76,61,0.000016
I'll just leave this here,,,3,10,13,9,0.000011
DeCadence Comic,,,2,11,13,13,0.000016
Southern Decadence,,,3,6,9,35,0.000015
Dead-Pool,,,0,25,25,58,0.000011
Jeff Hardy,,,7,63,70,15,0.000022
Online Gambling,,,11,22,33,23,0.000019
Madman C,,,2,51,53,2,0.000012
Dead Frontier,,,1,59,60,49,0.000011
Killing Floor,,,7,62,69,49,0.000015
Dead Frontier/Users,,,0,66,66,17,0.000011
Taboo,,,4,25,29,46,0.000014
Moshzilla,,,4,34,38,3,0.000012
Psytrance,,,4,48,52,37,0.000025
Level Up,,,8,35,43,49,0.000017
Pro-life,,,10,2,12,14,0.000018
Ninja Gaiden,,,7,61,68,49,0.000017
Free Step Dodge,,,2,31,33,28,0.000011
Rosa Parks,,,3,9,12,35,0.000011
Dead to Rights,,,1,21,22,49,0.000011
The Booty Warrior,,,13,17,30,39,0.000028
Nicotine Warrior,,,3,42,45,32,0.000013
Protest Warrior,,,4,13,17,37,0.000013
Deadly.org,,,1,7,8,55,0.000012
Dean,,,2,13,15,9,0.000013
Dear Hasbro,,,2,16,18,7,0.000011
Dearasshole,,,2,7,9,8,0.000012
Dearlightdragon,,,6,9,15,27,0.000014
Booted,,,1,0,1,27,0.000012
Kewllimesrevenge,,,5,10,15,8,0.000038
Flashman,,,4,2,6,8,0.000035
PogoRoo,,,2,19,21,31,0.000029
Death Grips,,,9,25,34,12,0.000016
WikiProject,,,4,38,42,2,0.000012
Deathcore,,,12,125,137,12,0.000027
Pastede on,,,1,8,9,8,0.000012
Death Note Online,,,1,32,33,22,0.000012
Sakujo,,,5,21,26,64,0.000022
Death of a Meme,,,7,21,28,9,0.000035
El Blog del Narco,,,4,3,7,35,0.000018
Jack Gilbert Graham,,,9,51,60,58,0.000019
Neil Breen,,,3,55,58,34,0.000012
Fail Blog,,,8,43,51,32,0.000097
Nu metal,,,17,169,186,12,0.000048
PMRants,,,6,32,38,7,0.000014
Michael Rosen,,,3,12,15,9,0.000011
Deathdrake 3000,,,1,12,13,9,0.000011
Deathy,,,1,5,6,41,0.000011
WebTV,,,1,9,10,3,0.000013
Debra Lafave,,,4,25,29,39,0.000036
Debug,,,1,23,24,3,0.000014
Multi-Track Drifting,,,6,4,10,9,0.000015
Msgmcmuffin,,,2,8,10,10,0.000014
Nigglesworth,,,2,5,7,26,0.000012
Grin Reaper,,,5,12,17,9,0.000015
Prolly,,,9,5,14,38,0.000051
Decendingskulls,,,3,34,37,26,0.000011
Deehubs Raid,,,2,8,10,19,0.000011
Richland Collegiate High School,,,3,82,85,58,0.000012
Larathen,,,6,22,28,21,0.000021
Deeker/Girl's Guide to Deekerianism,,,1,11,12,56,0.000011
Deeker/Stories,,,1,0,1,22,0.000011
Deeker/Bedwetting Management System,,,1,0,1,22,0.000011
Deeker/Quotes,,,1,6,7,54,0.000011
Enabling,,,1,0,1,54,0.000012
SoulPancake,,,3,18,21,12,0.000015
Jaden Smith,,,4,6,10,9,0.000015
Hitman Network,,,3,20,23,13,0.000016
Sad Satan,,,11,33,44,13,0.000036
Free market,,,1,0,1,14,0.000011
Mockney,,,1,0,1,14,0.000011
Skeet,,,1,0,1,14,0.000011
Jimmybobob79,,,1,0,1,8,0.000014
Defend Our Hoodz,,,0,12,12,35,0.000011
JihadUnspun.com,,,6,14,20,37,0.000017
Sheikh Yarbouti,,,6,5,11,37,0.000017
Night of Bush Capturing,,,5,16,21,37,0.000019
Defil3d,,,4,6,10,49,0.000014
Deflate Gate,,,0,22,22,60,0.000011
Facebook Friend Culling,,,6,43,49,59,0.000026
Dejimachan,,,6,20,26,9,0.000014
Del.icio.us,,,0,18,18,10,0.000011
Ning,,,8,19,27,48,0.000016
Delaware State University Shooting,,,3,22,25,35,0.000013
Data recovery,,,1,0,1,8,0.000012
Time-generating techniques,,,13,1,14,46,0.000036
We,,,10,7,17,13,0.000054
Wonderland,,,5,18,23,35,0.000018
Reno,,,4,11,15,40,0.00006
Minneapolis,,,6,25,31,35,0.000041
Latvia,,,21,59,80,37,0.000054
Here,,,6,20,26,3,0.000044
Zobovor,,,2,22,24,41,0.000016
Scott Stapp punked,,,6,7,13,40,0.000019
Deleterius,,,1,12,13,21,0.000016
Frankbertrand,,,1,12,13,48,0.000011
JacobDarkgod,,,2,48,50,51,0.000011
Tinaecmusic,,,6,20,26,0,0.000012
Vipor231,,,8,7,15,48,0.00002
Rodney Harris,,,2,18,20,48,0.000012
Jack Merridew,,,8,28,36,2,0.000014
Dragonfiend,,,5,16,21,2,0.000017
Simple Wikipedia,,,10,40,50,2,0.00002
Worst picture ever,,,7,14,21,6,0.000043
Riddle Time,,,6,15,21,9,0.000031
Areolæ,,,1,0,1,28,0.000012
Deliverance,,,0,8,8,32,0.000011
Zoey Zane,,,5,20,25,36,0.000016
Delthero,,,2,30,32,21,0.000015
Deluge,,,1,20,21,10,0.000011
George4title,,,5,41,46,17,0.000015
Tampon,,,14,34,48,39,0.000028
IdeaWiki,,,8,24,32,7,0.000014
Demine0,,,1,21,22,26,0.000011
Liver,,,3,15,18,48,0.000016
Spectrophilia,,,7,25,32,22,0.000026
Demonista,,,2,17,19,63,0.000012
Second,,,8,5,13,9,0.000087
Demonoid,,,5,23,28,10,0.000021
Smut,,,1,0,1,10,0.000011
Romare Bearden,,,1,11,12,9,0.000014
Safety Signs,,,1,1,2,9,0.000014
Foshata,,,5,40,45,54,0.000017
Victor1st,,,5,17,22,33,0.000014
Kyhell,,,5,20,25,48,0.000017
Forkbomb,,,3,23,26,10,0.00002
Ping,,,5,8,13,10,0.000022
Stalking Cat,,,3,16,19,11,0.000013
Larry King,,,6,14,20,41,0.000016
Dennis Hopper,,,3,1,4,41,0.000011
Dennis Kucinich,,,5,22,27,14,0.000022
Nick Bravo,,,16,50,66,48,0.000038
Depression Dog,,,5,15,20,9,0.000019
Derek Jeeves,,,2,2,4,48,0.000011
Nasim Aghdam,,,7,39,46,58,0.000022
Dernek.ba,,,3,80,83,38,0.000034
Derogatory Duck,,,2,5,7,9,0.000012
Johnny Depp,,,13,20,33,10,0.000029
Mark Barton,,,6,40,46,58,0.000014
Des Gregor,,,1,10,11,38,0.00002
Desktop,,,8,51,59,10,0.000057
Rainmeter,,,3,23,26,10,0.000014
File system,,,2,16,18,10,0.000014
FFA,,,16,53,69,52,0.000047
DestroyahDes,,,1,47,48,21,0.000011
Forum invading,,,3,24,27,9,0.000018
DesuRadio,,,6,27,33,9,0.000022
Desuchan/History of Desuchan,,,2,54,56,9,0.000011
Openbook,,,6,19,25,59,0.000026
Determination,,,2,49,51,58,0.000036
Jessica Lynn Evert,,,6,98,104,52,0.00002
DeterminedToDrawUT,,,6,38,44,7,0.000024
Rebornica,,,3,82,85,19,0.000012
Plotahedron9,,,2,16,18,7,0.000016
Detoxsun,,,1,14,15,31,0.000011
Mackenzie,,,2,13,15,36,0.000012
The jungle,,,1,0,1,35,0.000012
Clean,,,1,0,1,17,0.000011
Divergent,,,1,45,46,40,0.000011
Dev-catscratch,,,4,37,41,7,0.000019
Rolf Harris,,,7,33,40,17,0.00002
Joeysworldtour,,,2,26,28,34,0.000011
MichaelSquishyEddy89,,,3,23,26,7,0.000016
PhantomStrider8,,,4,37,41,34,0.000014
Encyclopedia Dramatica:Userboxes,,,11,0,11,2,0.000029
The Great DA Troll of 2007,,,5,14,19,21,0.000011
Nyu's Art Meme,,,3,44,47,21,0.000031
Diva,,,11,31,42,21,0.000019
Elfwood,,,8,28,36,31,0.000017
Ke-Kaikunane-o-Seer,,,4,31,35,31,0.000027
LineRider,,,3,6,9,49,0.000015
Massifesto,,,2,11,13,15,0.000015
Shadow Dinosaur,,,3,39,42,7,0.000016
Shoogerbare,,,1,7,8,21,0.000015
Smorekitty97,,,4,29,33,19,0.000015
Vigouroux,,,3,28,31,21,0.000039
Yuikami,,,3,24,27,21,0.000017
Banditkazoo,,,2,0,2,21,0.000015
DeviantArtSecret,,,3,30,33,21,0.000011
DeviantArtTART,,,1,36,37,21,0.000011
Rawrgimmeahug,,,3,33,36,31,0.000011
Okiamu,,,3,21,24,23,0.000011
E-dentity,,,6,11,17,8,0.000019
Smex,,,3,9,12,3,0.000035
Devilca-The-Hedgehog,,,2,8,10,23,0.000011
Devin Lesang,,,3,17,20,31,0.000011
Jaclyn Glenn,,,3,11,14,19,0.000012
Dexter243,,,0,21,21,7,0.000011
Ketamine,,,7,14,21,12,0.000022
Slurs,,,1,0,1,35,0.000011
Dextromethorphan/Motel Saturday Night,,,2,55,57,37,0.000013
Nuts4butts,,,1,0,1,8,0.000018
DiKKv,,,2,8,10,41,0.000014
Grogv,,,2,4,6,41,0.000013
John Bolton,,,6,14,20,52,0.000039
PieAreSquare,,,7,13,20,26,0.00003
The Shadow,,,3,72,75,26,0.000013
Diamondhortensia,,,0,9,9,34,0.000011
Dianna Kirkland,,,0,3,3,47,0.000011
Tanasinn,,,2,6,8,9,0.000014
E.S. Nigger Brown Stand,,,5,21,26,35,0.000029
HorseNews,,,4,10,14,41,0.000017
EVERYDAY I'M HUSTLIN,,,11,18,29,9,0.000027
Diaper dude,,,2,22,24,32,0.000013
Stormdragonblue,,,4,49,53,31,0.000014
Diarist,,,1,5,6,55,0.000011
TheoTheFox,,,5,24,29,31,0.000013
Dick Sickler,,,2,19,21,26,0.000035
Dick Impalement,,,6,4,10,31,0.000037
Tape dick,,,1,2,3,34,0.000035
Ticks on dick,,,4,1,5,39,0.000044
Willy Bum Bum,,,5,0,5,39,0.000013
Fucking internet,,,3,10,13,3,0.000019
Realstreamnews,,,4,114,118,39,0.000012
Slash Firestorm,,,8,152,160,18,0.000017
Sirtom93,,,12,65,77,4,0.000038
Laced,,,1,0,1,26,0.000012
Delicious loli,,,1,0,1,26,0.000012
Dickipedia,,,1,40,41,1,0.000011
Dictate,,,2,31,33,10,0.000011
Did he died?,,,7,28,35,32,0.000014
Evil-unveiled.com/Didaskalos,,,1,3,4,43,0.000013
Didaskalos/Presentation,,,1,0,1,43,0.000013
Diego Grez/Diegoquotes,,,0,2,2,56,0.000011
The Hand of Clod,,,14,90,104,9,0.000024
Robbenball,,,6,18,24,9,0.00003
Net Authority,,,7,23,30,10,0.000015
Shoutwire,,,5,29,34,10,0.000022
Tranzutopia,,,7,19,26,41,0.000014
DigiRaid,,,2,71,73,41,0.000011
Pokéclipse,,,4,19,23,41,0.000011
Tedius Zanarukando,,,4,14,18,39,0.000014
Epic Sax Guy,,,4,9,13,37,0.000013
Kodomo no Jikan,,,5,43,48,28,0.000028
Stefonknee,,,2,19,21,19,0.000011
Digibutter.nerr,,,3,61,64,49,0.000012
Life partner,,,14,20,34,28,0.000022
Digimon Battle,,,2,8,10,37,0.000011
Jaikesghost,,,1,0,1,48,0.000011
The Dot.Com Bubble,,,8,22,30,4,0.000038
Tigerwolf,,,4,13,17,8,0.000014
Flounces,,,1,0,1,8,0.000012
Shannonkringen,,,4,15,19,8,0.000014
The Song Of My People,,,2,2,4,25,0.000019
DreamWorks,,,8,125,133,34,0.000027
Dillon The Hacker,,,1,15,16,7,0.000011
Dilton Doiley,,,3,18,21,9,0.000012
Dimensional Entertainment,,,1,4,5,28,0.000012
Dimensions,,,1,6,7,52,0.000012
Dimitri The Lover,,,10,58,68,8,0.000025
Rickroll: Variations and assorted crap,,,1,5,6,9,0.000011
Djna,,,2,20,22,8,0.000011
DreamHost Does Not Obey The Law,,,3,16,19,8,0.000012
Lmaonade,,,19,11,30,48,0.000147
Josephthelover/arbchat,,,1,0,1,8,0.000011
Dimitrious Gargasoulas,,,0,18,18,58,0.000011
Dimmuborgiress,,,2,23,25,12,0.000011
Tinkebell,,,6,14,20,25,0.000019
Dinosaur Erotica,,,3,10,13,46,0.000033
Tyrannosaurus Reich,,,7,16,23,46,0.000016
Sex tourism,,,1,0,1,46,0.000014
Dio,,,3,5,8,12,0.000018
Dirk jan,,,0,15,15,37,0.000011
Kanker,,,3,13,16,37,0.000021
Dirty Disney Confessions,,,5,17,22,22,0.000018
Plox,,,8,4,12,9,0.000018
Skub,,,4,19,23,9,0.000011
Emoji,,,12,4,16,19,0.00002
Eris,,,5,28,33,8,0.000015
Pet Shaming,,,4,12,16,25,0.000019
Internet crushes,,,1,0,1,13,0.000016
Skullworm,,,4,13,17,10,0.000019
Pokchu,,,3,15,18,2,0.000012
Robert Pierson,,,6,33,39,2,0.000016
The Missing Talk Page Of VandalFucker,,,3,59,62,2,0.000012
The Great ED Civil War of 2018,,,6,45,51,52,0.00002
TheDOSFag,,,6,56,62,52,0.00002
Dramacunts,,,4,52,56,2,0.000025
Dislikes,,,5,41,46,24,0.000012
I a£ so drink eight now,,,3,0,3,2,0.000012
Lee Rigby,,,6,55,61,37,0.000015
Serious Discussion,,,3,43,46,38,0.000011
The Asylum,,,6,62,68,34,0.000014
Fritz the Cat,,,1,32,33,31,0.000013
Jasonspeaks,,,9,113,122,48,0.000015
Disney Princes,,,2,26,28,40,0.000013
Kovu 01,,,3,14,17,31,0.000013
Lemonade Mouth,,,1,12,13,35,0.000013
JohntheEnforcer,,,3,27,30,21,0.000011
Fauxlimia,,,7,7,14,52,0.000032
Psychochondria,,,4,28,32,7,0.000015
Disruptive Durden,,,3,3,6,9,0.000015
Jahi/4444,,,4,43,47,21,0.000012
Palshife,,,2,30,32,31,0.000012
StukaFox,,,4,6,10,31,0.000012
Sayfullo Saipov,,,5,18,23,37,0.000013
DivineAngel/Logs,,,1,1,2,21,0.000012
DizzyMissLizzi,,,6,30,36,7,0.000037
Misandry-Mermaid,,,3,22,25,7,0.000012
Galaxyprincet,,,5,41,46,7,0.000017
Djdlikesxbox/Chat logs,,,1,1,2,48,0.000011
Djdlikesxbox/Transcript,,,1,3,4,48,0.000011
Djent,,,1,13,14,12,0.000011
Dmzpkts,,,0,1,1,58,0.000011
Dncingmalkavian,,,3,33,36,8,0.000012
Goth macros,,,2,9,11,8,0.000011
Doc James,,,1,29,30,39,0.000012
Dr.Choker and Pals,,,1,9,10,23,0.000012
Dr. Hax,,,4,41,45,49,0.000014
Dr. Tran,,,3,33,36,39,0.000013
DoctorRandomercam,,,0,15,15,19,0.000011
Hospital,,,7,47,54,22,0.000017
Dr. Phail,,,1,4,5,60,0.000013
Jessica Beagley,,,3,4,7,48,0.000014
Neighbours,,,4,30,34,42,0.000018
Reaction Strip,,,4,17,21,9,0.000018
Safety,,,5,12,17,1,0.000018
Doctor Who Companions,,,1,63,64,33,0.000012
Mudshark,,,9,39,48,35,0.000026
Dodgeman,,,0,48,48,36,0.000011
DodgerofZion,,,2,21,23,26,0.000013
Does anyone have any questions?,,,2,3,5,9,0.000014
Nigger (Dog),,,1,8,9,35,0.000014
Giant George,,,4,3,7,49,0.00002
Stoner Dog,,,7,18,25,9,0.000026
Fap Dog,,,2,4,6,9,0.000014
Good Advice Dog,,,4,4,8,9,0.000015
Old Advice Dog,,,2,2,4,53,0.000014
Racist Dog,,,2,3,5,35,0.000014
"On the Internet, nobody knows you're a dog",,,3,3,6,3,0.000019
Pirate Dog,,,2,5,7,10,0.000017
Dog Bone,,,2,9,11,38,0.000012
Dogcow,,,1,6,7,10,0.000012
Orson Welles,,,11,32,43,1,0.000098
Le X Face,,,3,1,4,9,0.000015
Internet linguistics,,,5,94,99,25,0.000019
Dogs On Acid,,,5,25,30,3,0.000014
Gynophobia,,,3,12,15,49,0.000012
DoladdarKate,,,3,9,12,28,0.000012
Dolemite,,,3,15,18,34,0.000033
Vampirella87,,,4,50,54,21,0.000013
KawaiiKittee88,,,6,78,84,36,0.000016
Thagreatcreator,,,2,45,47,28,0.000011
Dollfie/StephG,,,1,8,9,34,0.000011
Dollfie/KimP,,,1,5,6,61,0.000011
Djbb,,,1,0,1,63,0.000014
Undulating dolphin,,,2,6,8,41,0.000026
SelauraNetherfield,,,2,19,21,21,0.000011
Mumsnet,,,8,42,50,39,0.000035
Dominican Republic,,,4,14,18,35,0.000014
Grue,,,9,22,31,13,0.000019
Tess Holliday,,,7,26,33,52,0.000018
"Don't ask, don't tell",,,4,10,14,37,0.000013
Military Wives,,,8,22,30,37,0.000016
Levenator,,,2,19,21,8,0.000013
Michelle Belanger,,,14,72,86,27,0.000027
Todd Hoyt,,,8,15,23,27,0.000021
Don Murphy,,,3,7,10,2,0.00002
Riana,,,8,29,37,2,0.000017
Don Roberts,,,0,23,23,7,0.000011
McLeodGaming,,,3,77,80,9,0.000011
Suit,,,2,6,8,26,0.000012
Donald Drumpf/Spam,,,0,2,2,46,0.000011
Donate/Success,,,0,1,1,8,0.000011
Donation Grandstanding,,,4,45,49,51,0.00004
Moon beam 750,,,5,53,58,0,0.000012
Zenophile,,,6,44,50,41,0.000013
User:Lmte,,,1,0,1,52,0.000011
ED Lifecycle,,,3,46,49,2,0.000012
Wikipedia Articles for deletion/Encyclopedia Dramatica,,,6,76,82,2,0.000017
Krashed,,,8,41,49,10,0.000017
Neomoti,,,2,11,13,21,0.000011
Example.txt,,,5,29,34,2,0.000012
Donut Girl,,,3,8,11,52,0.000021
Ronders,,,4,10,14,52,0.000022
Doodle,,,1,5,6,7,0.000012
ESRB,,,8,53,61,50,0.000021
Mouse poop,,,2,15,17,10,0.000012
Doom 4,,,3,19,22,49,0.000013
DoomSlayer34,,,1,10,11,7,0.000011
Doomsday Clock,,,0,32,32,14,0.000011
Doomsday Preppers,,,2,10,12,35,0.000015
Doomsdaytails,,,3,35,38,31,0.000011
Doopie DoOver/Art,,,1,22,23,28,0.000012
Doopie DoOver/Drugs,,,6,18,24,35,0.000029
Doopie DoOver/Sick Fuckery,,,1,94,95,53,0.000012
GothNebula,,,4,10,14,19,0.000014
Dorain1,,,0,10,10,49,0.000011
Dorian Gay,,,2,93,95,7,0.000017
Toxic Avenger,,,3,4,7,34,0.000012
Robert Stainek,,,4,58,62,32,0.000019
Mwmiller,,,1,17,18,8,0.000015
Casual,,,1,0,1,49,0.000011
Dot sex snark,,,3,10,13,8,0.000011
Vaginapagina,,,4,4,8,8,0.000038
DoubleSAnimations,,,3,3,6,21,0.000014
Double Take,,,0,10,10,32,0.000011
When /b/ was good,,,5,4,9,9,0.000023
Styla,,,8,26,34,57,0.000041
Tssz,,,6,17,23,0,0.000022
DougsTech,,,5,34,39,2,0.000011
Wild Wolf Society,,,5,65,70,31,0.000012
Downing Street Memo,,,2,21,23,14,0.000019
Dowww,,,0,3,3,44,0.000011
Hann,,,12,41,53,10,0.000024
Operation Onymous,,,1,14,15,10,0.000011
John Field,,,3,15,18,10,0.000014
Jennifer Emick,,,8,185,193,26,0.000014
Ronbryn,,,6,37,43,17,0.000013
Xnite,,,5,16,21,10,0.000013
Dr. Beary,,,1,27,28,31,0.000011
Dr. Laura Schlessnigger,,,6,44,50,39,0.000012
Helen Thomas,,,5,44,49,37,0.000012
Dr. Octogonapus,,,4,15,19,9,0.000012
Dr. Rushberry,,,7,2,9,18,0.000022
Dr4g0nK1d/Bel-Air'D,,,1,2,3,38,0.000011
Dr4g0nK1d/Transcript,,,1,0,1,26,0.000011
DrMusic2/The weregrinch in your closet,,,1,0,1,7,0.000011
DrMusic2/Fright Force,,,1,1,2,37,0.000011
DrMusic2/Grinchin Out,,,1,0,1,7,0.000011
DrMusic2/The Truth Behind ED,,,1,0,1,7,0.000011
DrMusic2/Night Of The EDiots,,,1,0,1,7,0.000011
DrMusic2/School rant,,,1,0,1,7,0.000011
DrMusic2/The benefits of being a werejc,,,1,0,1,7,0.000011
DrMusic2/Werejohncandy tf guide,,,1,0,1,7,0.000011
DrMusic2/Werejc facts,,,1,0,1,7,0.000011
DrMusic2/History of the werejohncandy,,,1,0,1,7,0.000011
DrMusic2/Brotherhood of the werejc,,,1,0,1,7,0.000011
DrMusic2/Werejohncandyism For Nitwits,,,1,0,1,7,0.000011
DrMusic2/Chronicles Of A Werejohncandy,,,1,0,1,7,0.000011
DrMusic2/How to care for a werejc,,,1,0,1,7,0.000011
DrMusic2/Werejcs and MJ,,,1,0,1,7,0.000011
DrMusic2/Infamous werejc,,,1,0,1,7,0.000011
DrMusic2/John Candy For A Week,,,1,0,1,7,0.000011
DrMusic2/A Werejohncandy tale,,,1,0,1,7,0.000011
DrMusic2/10 drawbacks to being a werejc,,,1,0,1,7,0.000011
DrMusic2/About the werejohncandy,,,1,0,1,7,0.000011
DrMusic2/The life of a werejohncandy,,,1,0,1,7,0.000011
Ondore,,,8,10,18,9,0.000014
DrMusic2/Cake Or Death,,,1,0,1,7,0.000011
Reverse trap chan,,,3,10,13,9,0.000014
Draconic,,,6,40,46,31,0.000014
Embracing Mystery,,,6,18,24,31,0.000019
Draggane,,,0,3,3,39,0.000011
Scion of the DragonPhoenix,,,2,46,48,12,0.000012
Dragonguyver,,,3,18,21,31,0.000013
Dragonmorph,,,11,67,78,31,0.000018
Sil the Wolfdragon,,,5,22,27,31,0.000012
TwistedDragon,,,2,19,21,31,0.000012
Kama Sutra,,,5,30,35,63,0.000011
Dragon Quest,,,2,15,17,40,0.000012
Meepsheep's Law,,,8,17,25,12,0.000039
Evil-unveiled.com/Philia,,,4,5,9,43,0.000043
Wanksox,,,3,3,6,18,0.000011
Narc,,,8,16,24,10,0.00002
Maxtaro,,,2,13,15,31,0.000011
Jibba Foxcoon,,,2,22,24,31,0.000011
FurNet,,,8,29,37,31,0.000013
Life story,,,4,4,8,8,0.000014
Dragonthunder123,,,2,7,9,7,0.000011
Drakengard,,,0,15,15,28,0.000011
JoJo's Bizarre Adventure,,,12,71,83,28,0.000024
Drakon,,,1,3,4,13,0.000011
Infidelity,,,5,15,20,37,0.000041
Xavia,,,5,12,17,41,0.000044
Foxy Dani,,,3,22,25,31,0.00004
Drama Hotel,,,4,11,15,0,0.000013
Drama Queen Kim,,,6,26,32,8,0.000029
PB,,,1,4,5,8,0.000012
Wtf user info,,,2,61,63,8,0.000012
Heterosexual Invisibility,,,6,11,17,40,0.00002
Lesbian quiz,,,2,10,12,57,0.000011
Poko Ono,,,6,9,15,8,0.000029
Drama magnet,,,2,13,15,21,0.000014
Queen Kong,,,15,25,40,35,0.000075
Kakyuu kou,,,2,14,16,28,0.000018
Kevn,,,5,6,11,8,0.000035
Pleasant muse,,,4,20,24,8,0.000018
Samia,,,8,8,16,8,0.000041
Drama yacht,,,3,6,9,8,0.000018
The Tigerwolf Effect,,,10,25,35,8,0.000015
Dramapedia,,,3,4,7,6,0.000031
Skylos,,,5,8,13,31,0.000017
Re/b/oot,,,1,0,1,32,0.000011
Drawbunny-chan,,,2,10,12,9,0.000011
DrawerJake,,,0,16,16,56,0.000011
Ragnarok Online,,,14,63,77,1,0.000021
IScribble,,,3,99,102,21,0.000011
Drayeart,,,1,15,16,21,0.000013
Dreadnought/rape,,,1,3,4,24,0.000011
User:Twid,,,4,0,4,41,0.000017
Packetgrinder,,,2,3,5,52,0.000013
Girlvinyl.com,,,1,0,1,8,0.000011
So cash/variations/Celebrity Cash,,,3,59,62,2,0.000011
Secret Nazi,,,7,17,24,37,0.000093
Shenmue Dojo,,,2,0,2,6,0.000011
Dreamer72fem,,,0,2,2,48,0.000011
Warriors for Innocence,,,3,30,33,53,0.000011
Drew Pritt,,,5,71,76,6,0.000017
Drillcat,,,0,8,8,57,0.000011
Drinking Game,,,2,64,66,9,0.000011
Mark Levin,,,7,45,52,14,0.000015
Driv3r,,,1,4,5,61,0.000011
DrossRotzank,,,2,17,19,19,0.000011
Wiminz,,,1,0,1,48,0.000011
Reymon14,,,4,16,20,51,0.000012
Drp1zza/IRC,,,1,0,1,48,0.000011
The Drudge Retort,,,5,178,183,14,0.000012
Salvia,,,3,10,13,35,0.000019
Nutmeg,,,1,8,9,38,0.000017
Inhalants,,,4,35,39,35,0.000018
Grass City,,,7,52,59,41,0.000018
Dshocker,,,4,27,31,10,0.000013
Dstohl,,,2,5,7,12,0.000018
Duane Dog Chapman,,,3,24,27,35,0.000012
Duck Dynasty,,,8,99,107,35,0.000017
Technologically Impaired Duck,,,2,5,7,9,0.000012
DuckDuckGo,,,0,3,3,17,0.000011
Duckat,,,1,8,9,41,0.00003
Georgia Varley,,,4,40,44,36,0.000016
Duct Tape,,,2,11,13,39,0.000011
Zombo.com,,,3,3,6,2,0.000012
IMO,,,1,14,15,2,0.000011
Pentium,,,4,27,31,10,0.000013
Duke Otterland/Chat logs,,,1,3,4,5,0.000012
PNG,,,7,18,25,10,0.000019
Special:Upload,,,3,0,3,10,0.000019
Pedo bait,,,7,7,14,39,0.000017
Incels,,,1,0,1,35,0.000011
Clones,,,1,0,1,35,0.000011
Uri Geller,,,7,57,64,17,0.000017
Satanic Ritual Abuse,,,14,25,39,46,0.000025
Preview is for Pussies,,,4,9,13,2,0.000029
M,,,2,8,10,2,0.000014
NPC,,,5,3,8,49,0.000015
Stranger Things,,,2,34,36,15,0.000013
WpCyberstalking,,,5,29,34,2,0.000019
Durthas,,,2,50,52,38,0.000014
DustFungo,,,0,139,139,61,0.000011
Geoffrey Leonard,,,14,24,38,39,0.000044
Dustin,,,1,29,30,31,0.000011
John Cooper II,,,3,29,32,14,0.000021
Dwavenhobble,,,0,1,1,7,0.000011
Dwight Whorley,,,3,7,10,53,0.000027
Nadine Schweigert,,,3,14,17,52,0.000023
Nesshelper,,,3,34,37,8,0.000015
Pratt,,,1,17,18,7,0.000013
Shane Lee,,,3,35,38,7,0.000016
Franky,,,1,7,8,42,0.000013
Critics,,,1,0,1,7,0.000013
Animation elitists,,,1,0,1,7,0.000013
TTT,,,11,11,22,56,0.000031
Psychweasel,,,5,27,32,21,0.000015
Everyone on deviantart,,,1,0,1,7,0.000013
All brainwashed channel awesome victims,,,1,0,1,7,0.000013
Enterbots,,,1,0,1,7,0.000013
Mikethehuman113,,,1,0,1,7,0.000013
Firemaster92,,,1,0,1,7,0.000013
JaSonic,,,2,20,22,7,0.000014
Internet Reviewing,,,2,12,14,61,0.000014
All eneterbots,,,1,0,1,7,0.000013
SephirothPrincess941,,,11,111,122,7,0.000031
ThatKidDouglas,,,4,42,46,34,0.000015
Peter Popoff,,,6,58,64,46,0.000014
Nostalgia Chick,,,6,31,37,19,0.000016
Kat Dennings,,,6,22,28,36,0.000053
XLittle-Miss-Horrorx,,,1,0,1,7,0.000013
Femnazis on Youtube,,,1,0,1,7,0.000013
Everyone who worked on Frozen,,,1,0,1,7,0.000013
Anyone who worked on mlp really,,,1,0,1,7,0.000013
Cartoonaboos,,,1,0,1,7,0.000013
Frozenfans,,,1,0,1,7,0.000013
Vinnyvim,,,1,0,1,7,0.000013
That annoying frozen fantard whose name I cant remember,,,1,0,1,7,0.000013
Rose3212,,,5,17,22,21,0.000021
Saint fox,,,2,139,141,58,0.000013
Scuzz,,,3,39,42,54,0.00002
Dylan,,,0,7,7,58,0.000011
Dylan & Cole Sprouse,,,0,14,14,36,0.000011
Phantom409,,,6,77,83,48,0.000014
K00lAIDGIRL,,,11,69,80,48,0.000012
LambiSinClair,,,9,58,67,48,0.000016
MorganAnson,,,12,53,65,48,0.000013
TheSockDetective,,,11,65,76,48,0.000016
Dylan Marron,,,1,22,23,19,0.000011
Seriously.TV,,,1,22,23,19,0.000011
Dylan Schumaker,,,1,39,40,39,0.000011
Evil-unveiled.com/Aztram,,,9,8,17,43,0.000063
Evil-unveiled.com/The Night Raven,,,7,4,11,43,0.000033
Evil-unveiled.com/Dylan Thomas,,,1,7,8,43,0.000015
Shota-ku,,,2,7,9,43,0.000015
Dylann Storm Roof/Manifesto,,,1,0,1,58,0.000011
Fat People Hate,,,7,83,90,52,0.000014
Young Tubers United,,,30,52,82,48,0.000049
Troyriser,,,7,31,38,48,0.000015
Street cred,,,8,14,22,35,0.000021
Kineticlightning,,,3,26,29,21,0.000012
E-copyright,,,2,2,4,8,0.000014
Mikeroach113,,,8,102,110,12,0.000018
Ragreynolds,,,6,26,32,19,0.000015
Nemo Hana,,,3,13,16,31,0.000013
The Real Syko,,,1,44,45,21,0.000012
E-harem,,,7,5,12,8,0.000016
E-nnui,,,1,7,8,18,0.000012
Remedy,,,4,35,39,3,0.000016
E-tard,,,2,4,6,12,0.000045
Locke,,,8,2,10,1,0.000021
Plants vs. Zombies,,,2,72,74,13,0.000011
Keygen,,,4,7,11,20,0.000014
EBWFGame1,,,1,17,18,26,0.000013
Fredryk Phox,,,6,12,18,31,0.000014
Race Guy,,,2,46,48,35,0.000015
ED:Map/old,,,0,171,171,35,0.000011
Green,,,8,9,17,35,0.00002
SSCash,,,2,2,4,52,0.000011
ED Forums/Door1Edward0,,,1,17,18,24,0.000011
The Aztecs,,,3,20,23,35,0.000012
Silverhaze06,,,6,36,42,52,0.000013
Faggot of the Year,,,12,121,133,52,0.000034
EDF 2: Electric Boogaloo/Baya Rae 4900,,,0,1,1,9,0.000011
ED Exodus into The Promised Land,,,0,20,20,48,0.000011
Faye006,,,4,7,11,48,0.000015
Underbelly,,,6,14,20,48,0.000013
ED Facebook,,,2,12,14,9,0.000015
ED IRC etiquette,,,3,14,17,10,0.00002
Hey guys whats going on in here,,,7,14,21,9,0.000025
IRC FAQ,,,8,16,24,10,0.000044
ED Movie Night,,,3,33,36,34,0.000013
Megan Is Missing,,,5,44,49,13,0.000013
Gary Busey,,,10,20,30,36,0.000029
ED is Fast,,,1,22,23,19,0.000012
GmmbbdhvDICKS,,,1,0,1,48,0.000015
The Encyclopedia Dramatica Jews,,,3,0,3,2,0.000018
EFG Day Raid 07,,,2,4,6,9,0.000013
Joe,,,4,11,15,54,0.000012
Princess Portal,,,3,19,22,28,0.000014
Elexiel grae,,,2,29,31,5,0.000011
ENDtheNWO,,,1,15,16,8,0.000011
Toki Pona,,,3,16,19,37,0.000016
The Great Habbo Raid of July 2008,,,7,22,29,9,0.000033
Epic Red Ranger Manoeuvre,,,7,14,21,28,0.000036
Epic Win Girl,,,5,23,28,32,0.000025
Sean Matuszak,,,5,15,20,9,0.000019
Epic Guys,,,1,20,21,9,0.000018
Sam DeathWalker,,,3,26,29,49,0.000012
Silver Circle,,,4,39,43,49,0.000011
EQ2Flames/AdamPerson,,,2,17,19,49,0.000013
Cockdock,,,1,0,1,49,0.000011
Oldchan,,,6,23,29,9,0.000026
EverQuest II/Lodizal,,,2,11,13,49,0.000014
EQ2Flames/This isnt sea world,,,1,23,24,9,0.000011
TwilightSucks,,,13,79,92,32,0.00004
ESL,,,3,15,18,35,0.000012
Huggles,,,6,35,41,12,0.000014
ESS,,,1,10,11,39,0.000031
Zoe,,,11,7,18,2,0.000016
Goon Squad,,,5,14,19,8,0.000018
Nigger pig,,,9,11,20,9,0.000032
Talking Animals,,,1,19,20,25,0.000012
EZWolf,,,4,46,50,31,0.000016
You Forgot Poland,,,12,32,44,37,0.000029
X intensifies,,,4,22,26,7,0.000013
Gonads and Strife,,,3,10,13,9,0.000012
Loud noises,,,4,1,5,9,0.000012
Have you heard about Pangea Day?,,,1,3,4,14,0.000016
The Great Em/b/assy Security Leak of 2007,,,8,35,43,9,0.000024
Earth Eternal,,,5,24,29,31,0.000012
East Turkestan,,,5,27,32,37,0.000016
Meme Magic,,,9,33,42,19,0.000032
Liberia,,,6,34,40,35,0.000041
Toronto,,,12,77,89,35,0.000025
Ec-707,,,1,5,6,2,0.000011
Zapatero,,,6,24,30,9,0.00002
Echon,,,3,11,14,26,0.000015
Economist,,,2,19,21,46,0.000014
Jack,,,2,15,17,43,0.000012
Free Software Foundation,,,6,8,14,10,0.00002
PITR,,,2,4,6,8,0.000015
Peter Schiff,,,3,26,29,17,0.000012
Ecstasy AKA Darks,,,3,31,34,28,0.000011
Ed's Room,,,2,7,9,55,0.000014
The Hebrew Hammer,,,2,9,11,17,0.000024
Ed Balls,,,2,18,20,37,0.000014
Ed Gein,,,3,23,26,22,0.000011
Ed Rendell,,,7,22,29,35,0.000019
Ed Rodriguez,,,8,9,17,8,0.000035
EddBoy/Journal,,,1,2,3,21,0.000012
Eddie Van Halen,,,5,20,25,12,0.000017
Yngwie Malmsteen,,,12,21,33,12,0.000024
Eddie Wise,,,0,8,8,34,0.000011
SuperMarioLogan,,,6,66,72,57,0.000014
JFC,,,1,7,8,57,0.000011
Eddward4eva,,,4,101,105,32,0.000015
EddyTheOkapi,,,1,2,3,28,0.00002
Eden Belmont,,,0,30,30,22,0.000011
MySpace Trolls,,,12,142,154,41,0.000027
RockyandGinger4ever,,,7,105,112,21,0.000018
Editor for deletion,,,2,46,48,2,0.000011
Zodiac Vandal,,,7,10,17,2,0.000015
Pony,,,18,6,24,7,0.000032
Edward Elric,,,8,25,33,21,0.000015
Edwinsoft,,,1,11,12,17,0.000012
Egalitarianism,,,1,57,58,19,0.000011
Egomaniac-monster,,,3,1,4,7,0.000011
Hosni Mubarak,,,6,39,45,37,0.000013
Internet Revolution,,,7,18,25,37,0.000029
Eidos,,,6,36,42,32,0.000013
Les Six,,,7,91,98,32,0.000015
Gynaeolatry,,,4,0,4,39,0.000017
Eji Samuron,,,1,37,38,53,0.000011
Elaine Herzberg,,,0,20,20,19,0.000011
Electria,,,4,20,24,36,0.000014
Lolokaust,,,4,33,37,21,0.000052
Electronic,,,0,5,5,10,0.000011
Trans-Pacific Partnership,,,4,15,19,14,0.000013
Electronic Gaming Monthly,,,0,5,5,49,0.000011
Pussinboots,,,1,19,20,31,0.000011
Eli Kozin,,,3,15,18,21,0.000011
Elias Abuelazam,,,0,10,10,37,0.000011
Elie Wiesel,,,0,24,24,39,0.000011
Elite: Dangerous,,,0,12,12,13,0.000011
What is Love?,,,12,5,17,9,0.000024
Elitemaiden,,,3,57,60,8,0.000016
Eliza Hecht,,,0,3,3,59,0.000011
Elizabeth Hawkenson,,,2,23,25,36,0.000024
Elizabeth Minami Wyvill,,,3,17,20,19,0.000015
Elizabeth Warren,,,0,33,33,35,0.000011
Maxine Waters,,,1,40,41,14,0.000011
Jeff Flake,,,1,7,8,35,0.000011
Mock,,,5,0,5,19,0.000012
Elizuke94,,,0,15,15,7,0.000011
Ellen Bennett,,,1,11,12,19,0.000011
Volunteer Ministers,,,3,13,16,58,0.000012
Expelled: No Intelligence Allowed,,,5,30,35,46,0.000016
The Natural Living Man,,,3,45,48,35,0.000013
G-Zay,,,3,23,26,53,0.000015
Yuri Kochiyama,,,4,48,52,35,0.000015
Ellybish,,,0,18,18,60,0.000011
Cringeworthy,,,1,0,1,60,0.000011
Elmo,,,7,39,46,34,0.00002
JWZ,,,7,18,25,10,0.000028
Your Email,,,2,8,10,64,0.000014
PFBind,,,2,5,7,9,0.000012
Lithursday,,,5,30,35,9,0.000013
Emcee Nazza,,,0,6,6,38,0.000011
Emergence,,,0,15,15,28,0.000011
TakeShotAction,,,6,30,36,19,0.000012
EmiNet,,,3,37,40,10,0.000014
Soulseek,,,4,68,72,15,0.000012
Lured,,,1,3,4,41,0.000011
Emil O. W. Kirkegaard,,,0,39,39,19,0.000011
Glitter,,,2,4,6,17,0.000013
Emily,,,0,4,4,24,0.000011
Evil-unveiled.com/Infinity,,,7,4,11,43,0.000089
Emirates,,,0,6,6,37,0.000011
Emma,,,1,28,29,36,0.000013
Emma Drama,,,2,61,63,12,0.000016
Emmalina,,,5,32,37,8,0.000012
Emmahdorable,,,1,5,6,36,0.000011
Emmy Rossum,,,6,47,53,21,0.000013
Kitties' Law,,,4,37,41,12,0.000028
The Cave of Dragonflies,,,2,73,75,38,0.000024
Emogame,,,2,15,17,12,0.000024
J-emo,,,9,75,84,28,0.000043
Miss aveline,,,2,0,2,41,0.000024
TCK,,,7,33,40,37,0.000052
Secretlyevil9792,,,2,11,13,21,0.000024
Emogirl21,,,1,27,28,36,0.000011
Lunchmeats,,,1,0,1,12,0.000012
Smileys,,,5,4,9,3,0.00002
Kaputsky,,,3,35,38,31,0.000013
Emu War,,,1,19,20,9,0.00003
Encarta,,,3,16,19,10,0.000012
EnchantsRequiem,,,1,42,43,21,0.000011
Encryption,,,5,18,23,10,0.00002
PGP,,,3,13,16,10,0.000013
GPG4Win,,,2,24,26,10,0.000012
Encyclopedia.com,,,2,8,10,2,0.000013
"Encyclopedia Drammatica:Article of the Now/July 1, 2018 -",,,0,8,8,35,0.000011
"Encyclopedia Drammatica:Article of the Now/July 2, 2018 -",,,0,8,8,35,0.000011
Encyclopedia of Stupid,,,3,24,27,2,0.000014
Encyclopediadramatica Retreat,,,1,7,8,8,0.000019
Encyclopædia Britannica,,,3,19,22,2,0.000013
The Carr-Benkler Wager,,,7,7,14,2,0.000014
Endless Online,,,3,56,59,38,0.000012
Rakuhana,,,1,35,36,52,0.000011
Shaun Dykes,,,4,10,14,58,0.000014
Joe Blackburn,,,5,49,54,52,0.000033
Jonathan King,,,9,37,46,17,0.000021
Purple Aki,,,9,36,45,39,0.000019
Gail Dines,,,4,19,23,5,0.000038
Sgt. Slaughter,,,4,15,19,15,0.000016
I'm In Me Mum's Car,,,2,4,6,57,0.000016
I Will Beat A Rod Till... A Tank Empties,,,6,5,11,9,0.000036
Enhanced Recent Changes,,,4,1,5,2,0.000018
EnterVoid,,,3,12,15,31,0.000012
Entertainment Roleplay,,,2,40,42,8,0.000011
Enzo-Matrix,,,1,2,3,21,0.000011
EpicKitty54,,,2,9,11,48,0.000011
EpicMarioBros,,,2,15,17,57,0.000011
Mario Fan Games Galaxy,,,3,111,114,24,0.000013
Epic Battle,,,1,35,36,10,0.000012
Ror,,,5,6,11,28,0.000013
The Peckham Terminator,,,2,5,7,9,0.000015
OMGFacts,,,2,16,18,36,0.000013
Epic Fail Guy 2,,,2,14,16,9,0.000015
Epic Fail Kid,,,4,19,23,9,0.000016
Reverend Jacob K. Reist,,,3,42,45,48,0.000016
TheQuestionMarkMan,,,5,39,44,48,0.000017
Unrelated,,,1,0,1,9,0.000012
Tim Berners-Lee,,,4,51,55,2,0.000016
Epic Incest Dynasty,,,5,25,30,37,0.000047
Tenso,,,2,9,11,9,0.000013
Rider Kick,,,9,39,48,28,0.000024
Shawn Lonsdale,,,9,53,62,26,0.000017
Freezone,,,3,19,22,26,0.000016
Vincent Li,,,3,59,62,51,0.000013
I'm back faggots,,,3,24,27,41,0.000018
Posting in an epic thread,,,7,43,50,9,0.000013
Forced Meme Flamingo,,,3,17,20,9,0.000014
KDE,,,2,19,21,10,0.000012
Lynx,,,3,13,16,10,0.000014
Xydexx Squeakypony,,,10,59,69,31,0.00002
Eric,,,0,13,13,58,0.000011
Eric S. Raymond,,,7,26,33,10,0.000023
Eric Pepin,,,1,2,3,26,0.000011
Erica Kinsman,,,1,10,11,39,0.000011
Erik Bloodaxe,,,1,6,7,10,0.000012
Legion of Doom,,,5,9,14,10,0.000016
Ray Kurzweil,,,6,9,15,46,0.000014
Mason Wyler,,,3,41,44,40,0.000015
Erika Winchester,,,2,14,16,35,0.000014
Erlang,,,0,10,10,10,0.000011
Ermina,,,1,23,24,31,0.000011
Ernst Steiner,,,0,27,27,38,0.000011
Godfrey Elfwick,,,5,9,14,19,0.000012
Metacritic,,,1,0,1,35,0.000012
Esachasa/It's my life,,,1,2,3,21,0.000011
Escapedosmil,,,0,16,16,7,0.000011
Karmafist,,,3,23,26,2,0.000012
Essjay/Courier-Journal,,,1,3,4,5,0.000011
Essjay/TOW,,,1,13,14,2,0.000011
Goatse Girl,,,11,8,19,39,0.000065
Security Faggotry,,,7,17,24,10,0.000013
Ethereal-crow,,,6,69,75,46,0.000012
Fundamentalists,,,1,0,1,46,0.000011
Mary,,,2,10,12,55,0.000011
Ethereum,,,0,10,10,37,0.000011
Ranpha15,,,2,9,11,28,0.000011
Eugene Sevostyanov,,,0,9,9,34,0.000011
Eugene Sevostyanov/Russian,,,1,6,7,34,0.000012
Nelson Mandela,,,4,0,4,35,0.000019
Tunisia,,,6,14,20,37,0.000014
Kayne West,,,8,7,15,12,0.000022
Eurisko97,,,1,16,17,8,0.000011
Min baro,,,1,0,1,8,0.000011
EvaGeeks,,,1,1,2,28,0.000011
Ontario,,,4,59,63,14,0.000017
Evan Jensen The Perverse Paranormal Clown,,,0,5,5,41,0.000011
Evelyn Rei,,,0,14,14,37,0.000011
Murloc,,,5,20,25,60,0.000015
Phat lewt,,,1,0,1,49,0.000011
Fansy the Famous Bard,,,3,18,21,0,0.000012
The Cringe Channel,,,2,41,43,7,0.000011
Randomcasualty,,,2,6,8,21,0.000011
Le Parkour,,,10,63,73,39,0.00002
I Like Turtles,,,14,16,30,49,0.000059
Mafia Wars,,,5,33,38,47,0.00002
X Doesn't Change Facial Expressions,,,8,19,27,36,0.000051
GameCrush,,,6,30,36,49,0.000013
Everyday Feminism,,,0,20,20,19,0.000011
Everyday Sexism Project,,,0,16,16,53,0.000011
Everyonesfangirl,,,2,36,38,21,0.000011
Tosh,,,6,15,21,41,0.00003
Everything Is Terrible!,,,1,10,11,9,0.000011
Evil-unveiled.com/-7-,,,2,5,7,43,0.000011
Evil-unveiled.com/BoyBliss,,,49,13,62,43,0.000342
Evil-unveiled.com/Boylover.net,,,72,1,73,43,0.000493
Evil-unveiled.com/Boylove.net,,,24,15,39,43,0.000067
Evil-unveiled.com/Steven Jones,,,12,3,15,43,0.000135
Evil-unveiled.com/Pedospeak,,,128,11,139,43,0.000673
Evil-unveiled.com/-:A:-:R:-:T:-,,,0,5,5,43,0.000011
Evil-unveiled.com/ArtSapience.com,,,4,4,8,43,0.000027
Nn,,,1,0,1,43,0.000012
Evil-unveiled.com/The Persecution Delusion,,,4,8,12,43,0.000015
Evil-unveiled.com/28,,,5,5,10,43,0.000088
Evil-unveiled.com/Annabelleigh.net,,,115,13,128,43,0.000812
Evil-unveiled.com/Common Ground,,,21,19,40,43,0.000124
Evil-unveiled.com/GirlLove Garden,,,18,10,28,43,0.000208
Evil-unveiled.com/Abraxas,,,5,8,13,43,0.000036
Evil-unveiled.com/A0036992,,,2,1,3,43,0.000011
Evil-unveiled.com/Abby fan,,,3,6,9,43,0.000012
Evil-unveiled.com/Kidzlandonline.com,,,27,15,42,43,0.000126
The Forbidden Realms,,,4,4,8,43,0.000032
Evil-unveiled.com/TkGL,,,15,1,16,43,0.000059
Evil-unveiled.com/Abc,,,1,3,4,43,0.000011
Evil-unveiled.com/Jack McClellan,,,9,3,12,43,0.000038
Evil-unveiled.com/Abear,,,2,2,4,43,0.000011
Evil-unveiled.com/MrDouble.com,,,8,2,10,43,0.000136
Evil-unveiled.com/Newgon.com,,,19,3,22,43,0.000176
Evil-unveiled.com/Pedologues,,,29,2,31,43,0.000208
Evil-unveiled.com/Ad van den Berg,,,3,3,6,43,0.000042
"Evil-unveiled.com/Partij voor Naastenliefde, Vrijheid en Diversiteit",,,7,3,10,43,0.000074
Evil-unveiled.com/MARTIJN Association,,,5,5,10,43,0.000063
Evil-unveiled.com/Norbert De Jonge,,,6,5,11,43,0.000061
Evil-unveiled.com/Adam The Baroque Keyboardist,,,3,3,6,43,0.000029
Evil-unveiled.com/Free Spirits Coalition,,,58,42,100,43,0.000665
Evil-unveiled.com/Afin,,,4,4,8,43,0.000028
Evil-unveiled.com/BoyWrite,,,11,5,16,43,0.000079
Evil-unveiled.com/Age Taboo,,,14,17,31,43,0.000111
Evil-unveiled.com/Matthew Shaller,,,2,3,5,43,0.000016
Evil-unveiled.com/Epifora,,,13,2,15,43,0.000154
Evil-unveiled.com/Indoctrination Campaign,,,8,5,13,43,0.000048
Evil-unveiled.com/Howie,,,3,4,7,43,0.000021
Evil-unveiled.com/AirboyDS,,,4,8,12,43,0.000021
Evil-unveiled.com/Appy,,,5,8,13,43,0.000026
Dream brother,,,1,0,1,43,0.000016
Evil-unveiled.com/Emovocals,,,4,6,10,43,0.000018
Evil-unveiled.com/Fntm,,,5,6,11,43,0.000036
Evil-unveiled.com/Jd420,,,4,5,9,43,0.000019
Evil-unveiled.com/Jonty,,,5,5,10,43,0.000026
Evil-unveiled.com/Lek,,,13,6,19,43,0.000067
Evil-unveiled.com/Ppc,,,4,2,6,43,0.000092
Evil-unveiled.com/Thisoneguy,,,5,5,10,43,0.000022
Evil-unveiled.com/BoyMoment,,,59,3,62,43,0.000249
Evil-unveiled.com/Jizzony,,,9,3,12,43,0.000025
Evil-unveiled.com/Treader4862,,,7,6,13,43,0.000048
Evil-unveiled.com/Pimme,,,9,6,15,43,0.000024
Evil-unveiled.com/Boimatt,,,4,9,13,43,0.000018
Evil-unveiled.com/Akira Yamaoka Pwnz,,,1,2,3,43,0.000011
Evil-unveiled.com/Alanped,,,1,7,8,43,0.000011
Evil-unveiled.com/Boys Scout Camp,,,5,3,8,43,0.000024
Evil-unveiled.com/Todd Perkins,,,3,1,4,43,0.000013
Evil-unveiled.com/AoA,,,29,1,30,43,0.00012
Evil-unveiled.com/AlbertRoss,,,5,4,9,43,0.000108
Evil-unveiled.com/Jimf3,,,16,6,22,43,0.00008
Evil-unveiled.com/Tygyr,,,4,6,10,43,0.000025
Evil-unveiled.com/Alfie,,,2,2,4,43,0.000011
Evil-unveiled.com/Alistaircato,,,2,2,4,43,0.000015
Evil-unveiled.com/AllPages,,,0,514,514,43,0.000011
Evil-unveiled.com/Metatron,,,2,2,4,43,0.000011
Evil-unveiled.com/AOC,,,2,0,2,43,0.000014
Evil-unveiled.com/BLcop,,,1,3,4,43,0.000011
Evil-unveiled.com/Noshame,,,2,3,5,43,0.000011
Evil-unveiled.com/NaZaRo,,,2,2,4,43,0.000014
Evil-unveiled.com/Fachy,,,2,1,3,43,0.000011
Evil-unveiled.com/Captain Zen,,,2,1,3,43,0.000011
Evil-unveiled.com/Poisontears,,,2,5,7,43,0.000011
Evil-unveiled.com/Allaloneboy,,,8,4,12,43,0.000021
Evil-unveiled.com/Hangtwenty,,,1,2,3,43,0.000011
Evil-unveiled.com/Alt.fan.prettyboy,,,6,1,7,43,0.000032
Evil-unveiled.com/Alt.support.boy-lovers,,,9,2,11,43,0.000041
Evil-unveiled.com/Alt.support.girl-lovers,,,4,3,7,43,0.000023
Evil-unveiled.com/DJ Amadeus,,,2,3,5,43,0.000017
Evil-unveiled.com/Jan Kruska,,,13,1,14,43,0.000041
Evil-unveiled.com/Ambar,,,1,3,4,43,0.000011
Evil-unveiled.com/Pandaxboi,,,4,5,9,43,0.000014
Evil-unveiled.com/Angel boy,,,2,4,6,43,0.000015
Evil-unveiled.com/Piperrhiannon,,,2,3,5,43,0.000011
Evil-unveiled.com/Inygmuh,,,1,2,3,43,0.000011
Evil-unveiled.com/Apple,,,1,2,3,43,0.000011
Evil-unveiled.com/Aqua,,,2,5,7,43,0.000076
Evil-unveiled.com/Ashleigh,,,5,9,14,43,0.000025
Evil-unveiled.com/Atom,,,2,4,6,43,0.000024
Evil-unveiled.com/Phantom,,,3,5,8,43,0.000017
Evil-unveiled.com/BB,,,3,3,6,43,0.000081
Evil-unveiled.com/Jeremy Candal,,,4,8,12,43,0.000014
Evil-unveiled.com/BLinker,,,3,4,7,43,0.000028
Evil-unveiled.com/BLogo,,,4,3,7,43,0.000033
Evil-unveiled.com/BLueRibbon,,,2,4,6,43,0.000013
Evil-unveiled.com/Bach,,,7,10,17,43,0.000108
Evil-unveiled.com/Balas,,,1,2,3,43,0.000011
Evil-unveiled.com/Baldur,,,7,4,11,43,0.000087
Evil-unveiled.com/Barbeac0n,,,3,3,6,43,0.000012
Evil-unveiled.com/Justinian Draconis,,,4,1,5,43,0.000014
Evil-unveiled.com/Betty Price,,,12,7,19,43,0.000051
Evil-unveiled.com/Bigcd02,,,1,3,4,43,0.000011
Evil-unveiled.com/Biguy503,,,3,8,11,43,0.000019
Evil-unveiled.com/Bill Andriette,,,2,2,4,43,0.000013
Evil-unveiled.com/Bill Evans,,,5,1,6,43,0.000016
Evil-unveiled.com/Wcat,,,2,1,3,43,0.000011
Evil-unveiled.com/BoyLove Media Watch,,,5,2,7,43,0.000095
Evil-unveiled.com/Kittycat80,,,2,8,10,43,0.000011
Evil-unveiled.com/Boybuddy,,,2,3,5,43,0.000013
Evil-unveiled.com/Boy-lover-44,,,3,3,6,43,0.000011
Evil-unveiled.com/BoyLinks,,,9,1,10,43,0.000134
Evil-unveiled.com/BoyPassion,,,10,10,20,43,0.000046
Evil-unveiled.com/BoyTales,,,8,3,11,43,0.000138
Evil-unveiled.com/BoyTalk,,,9,2,11,43,0.000086
Evil-unveiled.com/BoyZoom,,,5,4,9,43,0.000089
Evil-unveiled.com/Boy Moment,,,2,0,2,43,0.000014
Evil-unveiled.com/BoysMagicWorld,,,13,15,28,43,0.000055
Evil-unveiled.com/Boyscents,,,2,8,10,43,0.000011
Evil-unveiled.com/BoysrUs,,,3,3,6,43,0.000018
Evil-unveiled.com/Boystory,,,5,6,11,43,0.000025
Evil-unveiled.com/ShadowedSunrise,,,3,5,8,43,0.000015
Evil-unveiled.com/Elfmagic,,,2,3,5,43,0.000011
Evil-unveiled.com/Brother1,,,3,1,4,43,0.000011
Evil-unveiled.com/Brother Chubba,,,4,6,10,43,0.000014
Evil-unveiled.com/Spike232,,,4,7,11,43,0.000018
Evil-unveiled.com/JagDawg,,,3,7,10,43,0.000013
Evil-unveiled.com/Buke,,,3,3,6,43,0.000026
Evil-unveiled.com/Christian Boylove Forum,,,23,3,26,43,0.000144
Evil-unveiled.com/CQ2,,,7,8,15,43,0.000053
Evil-unveiled.com/Cale Tucker,,,3,6,9,43,0.000029
Evil-unveiled.com/Cameldude,,,2,3,5,43,0.000011
Evil-unveiled.com/Camper,,,1,5,6,43,0.000011
Evil-unveiled.com/Cangee,,,2,3,5,43,0.000011
Evil-unveiled.com/CapNemo,,,3,6,9,43,0.000011
Evil-unveiled.com/Carrollingian,,,3,4,7,43,0.000013
Evil-unveiled.com/IsmAvatar,,,4,3,7,43,0.000072
Evil-unveiled.com/Catalyst of Change,,,2,7,9,43,0.000011
Evil-unveiled.com/Holokittynx,,,14,14,28,43,0.000045
Evil-unveiled.com/Cephaloped,,,2,1,3,43,0.000011
Evil-unveiled.com/Cerius,,,4,5,9,43,0.000029
Evil-unveiled.com/Ch0hag,,,3,3,6,43,0.000011
Evil-unveiled.com/Cheryl Griffiths,,,10,17,27,43,0.000034
Evil-unveiled.com/Childdriver,,,4,3,7,43,0.000012
Evil-unveiled.com/Chimpo,,,3,7,10,43,0.000013
Evil-unveiled.com/Chip,,,2,3,5,43,0.000011
Evil-unveiled.com/The non understood,,,2,2,4,43,0.000014
Evil-unveiled.com/Westcoaster,,,3,2,5,43,0.000011
Evil-unveiled.com/Chris Rainer,,,1,0,1,43,0.000011
Evil-unveiled.com/Christopher Kidwell,,,2,5,7,43,0.000022
Evil-unveiled.com/Slavetoboys,,,2,1,3,43,0.000011
Evil-unveiled.com/Cindy K,,,1,5,6,43,0.000011
Evil-unveiled.com/Tsand,,,5,11,16,43,0.000021
Evil-unveiled.com/Clayboy,,,4,4,8,43,0.000018
Evil-unveiled.com/Clint Hopper,,,2,2,4,43,0.000011
Evil-unveiled.com/Skull Dander,,,2,1,3,43,0.000011
Evil-unveiled.com/Coggle,,,3,6,9,43,0.000026
Evil-unveiled.com/Cogito Sum,,,3,1,4,43,0.000026
Evil-unveiled.com/FPJmask,,,2,2,4,43,0.000011
Evil-unveiled.com/CryptKeeper,,,2,1,3,43,0.000011
Evil-unveiled.com/Crispydruid,,,1,3,4,43,0.000011
Evil-unveiled.com/Criss,,,2,3,5,43,0.000021
Evil-unveiled.com/Crossroads Debate,,,3,5,8,43,0.000018
Evil-unveiled.com/Crysta,,,5,3,8,43,0.000015
Evil-unveiled.com/Cw5614,,,2,1,3,43,0.000015
Evil-unveiled.com/CyberBob,,,2,3,5,43,0.000011
Evil-unveiled.com/DJ Jack,,,2,3,5,43,0.000017
Evil-unveiled.com/DJ Jesse,,,2,4,6,43,0.000017
Evil-unveiled.com/Mother Renee,,,3,5,8,43,0.000029
Evil-unveiled.com/DJ X,,,2,3,5,43,0.000017
Evil-unveiled.com/Damian,,,2,4,6,43,0.000011
Evil-unveiled.com/Sorrow,,,5,6,11,43,0.000026
Evil-unveiled.com/Daniel Lièvre,,,4,6,10,43,0.000072
Evil-unveiled.com/Hierophant,,,3,3,6,43,0.000022
Evil-unveiled.com/Dante snake1116,,,5,2,7,43,0.000019
Evil-unveiled.com/DarkGiant,,,2,1,3,43,0.000016
Evil-unveiled.com/DarkIntellect,,,2,5,7,43,0.000013
Evil-unveiled.com/DarwinGL,,,4,4,8,43,0.000044
Evil-unveiled.com/Karaokedavid82,,,2,4,6,43,0.000016
Evil-unveiled.com/Ddlibnkc,,,3,3,6,43,0.000011
Evil-unveiled.com/David Riegel,,,4,5,9,43,0.000081
Evil-unveiled.com/David Thorstad,,,4,1,5,43,0.000017
Evil-unveiled.com/Daze,,,2,1,3,43,0.000011
Evil-unveiled.com/Deepsouth,,,1,1,2,43,0.000011
Evil-unveiled.com/DeirdreC,,,2,1,3,43,0.000011
Evil-unveiled.com/Demosthenes,,,2,1,3,43,0.000011
Evil-unveiled.com/Hoove164,,,2,2,4,43,0.000011
Evil-unveiled.com/TheGreatBL,,,2,3,5,43,0.000011
Evil-unveiled.com/Raelanura,,,2,4,6,43,0.000013
Evil-unveiled.com/Sweetguy201,,,2,2,4,43,0.000011
Evil-unveiled.com/Derek Logue,,,16,18,34,43,0.000049
Evil-unveiled.com/Descartes,,,2,1,3,43,0.000014
Evil-unveiled.com/Devholyjoke,,,3,1,4,43,0.000069
Evil-unveiled.com/Dissident57,,,3,5,8,43,0.000018
Evil-unveiled.com/Divinaw,,,5,4,9,43,0.000022
Evil-unveiled.com/Dj46041,,,2,3,5,43,0.000011
Evil-unveiled.com/Dlunytic,,,4,5,9,43,0.000037
Evil-unveiled.com/Donald Rispens,,,1,1,2,43,0.000011
Evil-unveiled.com/Donna Kistler,,,3,4,7,43,0.000015
Evil-unveiled.com/Doug9613,,,2,3,5,43,0.000018
Evil-unveiled.com/Dr. Frans Gieles,,,2,3,5,43,0.000017
Evil-unveiled.com/Dragongeo2,,,1,4,5,43,0.000011
Evil-unveiled.com/Dragonwhip,,,3,2,5,43,0.000011
Evil-unveiled.com/Dukethor,,,2,1,3,43,0.000011
Evil-unveiled.com/Ed,,,1,2,3,43,0.000011
Evil-unveiled.com/Egon,,,1,3,4,43,0.000011
Evil-unveiled.com/El Castillo Azul,,,2,2,4,43,0.000013
Evil-unveiled.com/Elijah Wood,,,5,5,10,43,0.000075
Evil-unveiled.com/ElijahsWorld,,,2,1,3,43,0.000016
Evil-unveiled.com/Ella,,,2,3,5,43,0.000011
Evil-unveiled.com/Matthew Harman,,,3,2,5,43,0.000011
Evil-unveiled.com/Elminster Trueheart,,,3,2,5,43,0.000013
Evil-unveiled.com/Ephebophile Dominic,,,2,2,4,43,0.000033
Evil-unveiled.com/Stewedsquirrel,,,2,4,6,43,0.000015
Evil-unveiled.com/Free Paed Cooperative,,,4,4,8,43,0.000029
Evil-unveiled.com/Father TMJR,,,4,4,8,43,0.000016
Evil-unveiled.com/Fleetwood,,,4,5,9,43,0.000036
Evil-unveiled.com/Gabriel James MacIsaac,,,5,9,14,43,0.000015
Evil-unveiled.com/FortyOne,,,3,1,4,43,0.000011
Evil-unveiled.com/Kanospower,,,4,11,15,43,0.000013
Evil-unveiled.com/SkySky05,,,3,5,8,43,0.000012
Evil-unveiled.com/FrediKinz,,,2,3,5,43,0.000011
Evil-unveiled.com/Freedom Board,,,5,4,9,43,0.000025
Evil-unveiled.com/Frianne,,,2,8,10,43,0.000012
Evil-unveiled.com/Zlurker,,,3,8,11,43,0.000014
Evil-unveiled.com/GLogo,,,5,3,8,43,0.000027
Evil-unveiled.com/Global-Unity,,,16,19,35,43,0.000044
Evil-unveiled.com/Gary Wolchesky,,,3,2,5,43,0.000011
Evil-unveiled.com/Ghost Writer,,,3,4,7,43,0.000018
Evil-unveiled.com/Gil Hardwick,,,2,1,3,43,0.000011
Evil-unveiled.com/GirlLinks,,,2,1,3,43,0.000016
Evil-unveiled.com/Girl Moment,,,1,0,1,43,0.000011
Evil-unveiled.com/GlWiki,,,10,17,27,43,0.000049
Evil-unveiled.com/Glen Hall,,,2,1,3,43,0.000011
Evil-unveiled.com/Technikal,,,3,2,5,43,0.000013
Evil-unveiled.com/Goodi2shoe,,,2,4,6,43,0.000018
Evil-unveiled.com/Gort,,,2,2,4,43,0.000018
Evil-unveiled.com/Jaje,,,2,2,4,43,0.000011
Evil-unveiled.com/Greencrystal,,,2,1,3,43,0.000011
Evil-unveiled.com/Greenfly,,,2,3,5,43,0.000011
Evil-unveiled.com/Gryffin,,,2,3,5,43,0.000011
Evil-unveiled.com/Guildsolutions,,,2,3,5,43,0.000014
Evil-unveiled.com/John Kapshaw,,,2,2,4,43,0.000011
Evil-unveiled.com/Hasmal,,,3,2,5,43,0.000026
Evil-unveiled.com/Heather Elizabeth Peterson,,,2,4,6,43,0.000018
Evil-unveiled.com/Highlander,,,3,3,6,43,0.000016
Evil-unveiled.com/Hínandil,,,3,3,6,43,0.000027
Evil-unveiled.com/Hitom,,,3,2,5,43,0.000011
Evil-unveiled.com/Hob,,,1,7,8,43,0.000011
Evil-unveiled.com/HoldenC,,,2,2,4,43,0.000024
Evil-unveiled.com/Robert Harold Young,,,2,2,4,43,0.000011
Evil-unveiled.com/Howard Kline,,,2,2,4,43,0.000016
Evil-unveiled.com/Hugger,,,2,2,4,43,0.000011
Evil-unveiled.com/Hulann,,,3,4,7,43,0.000026
Evil-unveiled.com/Humboldt,,,2,3,5,43,0.000011
Evil-unveiled.com/Hyacinth,,,2,4,6,43,0.000014
Evil-unveiled.com/Ilovegreenolives,,,2,8,10,43,0.000012
Evil-unveiled.com/International BoyLove Day,,,8,3,11,43,0.000085
Evil-unveiled.com/IPCE,,,7,5,12,43,0.000038
Evil-unveiled.com/Somersault,,,16,6,22,43,0.000081
Evil-unveiled.com/Ike14,,,5,8,13,43,0.000042
Evil-unveiled.com/JON,,,2,1,3,43,0.000016
Evil-unveiled.com/Webmanager Critest,,,9,3,12,43,0.000045
Evil-unveiled.com/Jackie Sparling,,,13,5,18,43,0.000042
Evil-unveiled.com/Jake Tiger,,,3,3,6,43,0.000018
Evil-unveiled.com/Jakk,,,1,3,4,43,0.000011
Evil-unveiled.com/James Cooper,,,3,2,5,43,0.000018
Evil-unveiled.com/Justoldhappyme,,,4,8,12,43,0.000026
Evil-unveiled.com/Onemilligram,,,2,1,3,43,0.000011
Evil-unveiled.com/Jason Garrison,,,4,7,11,43,0.000036
Evil-unveiled.com/Jean-Baptiste le Bonhomme,,,6,7,13,43,0.000033
Evil-unveiled.com/JeanBoy,,,2,4,6,43,0.000013
Evil-unveiled.com/Jeff Gold,,,3,5,8,43,0.000022
Evil-unveiled.com/Jensman,,,3,2,5,43,0.000012
Evil-unveiled.com/SOFightBack,,,3,0,3,43,0.000011
Evil-unveiled.com/Jessica Massey,,,3,1,4,43,0.000012
Evil-unveiled.com/Jillium,,,2,5,7,43,0.000013
Jim,,,1,20,21,43,0.000011
Evil-unveiled.com/Jim Burton,,,3,1,4,43,0.000013
Evil-unveiled.com/Jim Freeman,,,11,13,24,43,0.000034
Evil-unveiled.com/JoeCool4218,,,4,5,9,43,0.000014
Evil-unveiled.com/Joe Power,,,4,3,7,43,0.000017
Evil-unveiled.com/PersonInMyOwnEyes,,,3,2,5,43,0.000011
Evil-unveiled.com/John Clennon,,,1,4,5,43,0.000011
Evil-unveiled.com/John Melanson,,,6,7,13,43,0.000131
Evil-unveiled.com/John Robin Sharpe,,,3,1,4,43,0.000024
Evil-unveiled.com/Johnny Ray Lee,,,3,10,13,43,0.000015
Evil-unveiled.com/JonasBark,,,2,1,3,43,0.000013
Evil-unveiled.com/Jongens,,,5,2,7,43,0.000048
Evil-unveiled.com/Jungs,,,2,2,4,43,0.000024
Evil-unveiled.com/Reverend Justme,,,3,3,6,43,0.00002
Evil-unveiled.com/Justthere,,,3,6,9,43,0.000018
Evil-unveiled.com/KRB,,,3,2,5,43,0.000041
Evil-unveiled.com/Kaliko Kat,,,2,3,5,43,0.000013
Evil-unveiled.com/Kalos,,,3,8,11,43,0.000033
Evil-unveiled.com/Kasper,,,2,2,4,43,0.000013
Evil-unveiled.com/Kaylor,,,2,1,3,43,0.000011
Evil-unveiled.com/Kdogg9176,,,2,1,3,43,0.000011
Evil-unveiled.com/Keech,,,1,3,4,43,0.000011
Evil-unveiled.com/Mark Baker,,,6,8,14,43,0.000044
Evil-unveiled.com/Roger Keith Bloemers,,,2,2,4,43,0.000011
Evil-unveiled.com/Kero,,,4,5,9,43,0.000082
Evil-unveiled.com/Kevin Brown,,,5,3,8,43,0.000021
Evil-unveiled.com/KidBarber2,,,2,2,4,43,0.000011
Evil-unveiled.com/Kid Cuddler,,,1,2,3,43,0.000011
Evil-unveiled.com/Kissbyalice,,,2,3,5,43,0.000011
Evil-unveiled.com/Kody,,,1,5,6,43,0.000011
Evil-unveiled.com/Kurenai,,,2,5,7,43,0.000014
Evil-unveiled.com/LBLogo,,,2,3,5,43,0.000017
Evil-unveiled.com/LGT,,,2,1,3,43,0.000011
Evil-unveiled.com/La Garçonnière,,,1,2,3,43,0.000011
Evil-unveiled.com/Lammasu,,,3,4,7,43,0.000012
Evil-unveiled.com/Royal,,,2,3,5,43,0.000011
Evil-unveiled.com/LeX,,,2,2,4,43,0.000021
Evil-unveiled.com/Leakyfaucet,,,2,3,5,43,0.000011
Evil-unveiled.com/Leaven12,,,3,8,11,43,0.000018
Evil-unveiled.com/Lee Lee Lawless,,,11,7,18,43,0.000042
Evil-unveiled.com/Leland Stevenson,,,2,1,3,43,0.000011
Evil-unveiled.com/Lewis William Hendrix,,,2,4,6,43,0.000015
Evil-unveiled.com/Libertarian777,,,2,4,6,43,0.000011
Evil-unveiled.com/LifeLine,,,14,7,21,43,0.000132
Evil-unveiled.com/Lil Daryl,,,2,2,4,43,0.000018
Evil-unveiled.com/Linda Pehrson,,,17,16,33,43,0.000054
Evil-unveiled.com/Little Boy Lover Forum,,,17,7,24,43,0.000159
Evil-unveiled.com/Littlegirllover,,,2,1,3,43,0.000013
Evil-unveiled.com/Littlexs,,,2,3,5,43,0.000013
Evil-unveiled.com/Llewellyn,,,4,3,7,43,0.000035
Evil-unveiled.com/Logical Reality,,,14,7,21,43,0.000096
Evil-unveiled.com/Loren Robb,,,2,2,4,43,0.000011
Evil-unveiled.com/LostBoy,,,2,5,7,43,0.00043
Evil-unveiled.com/Lucani,,,2,3,5,43,0.000011
Evil-unveiled.com/Lupie,,,1,1,2,43,0.000011
Evil-unveiled.com/LyricalCancer,,,14,17,31,43,0.000029
Evil-unveiled.com/MRB,,,2,2,4,43,0.000013
Evil-unveiled.com/MaThiAs,,,2,3,5,43,0.000014
Evil-unveiled.com/Maintenance Elf,,,4,2,6,43,0.00003
Evil-unveiled.com/Mark McDowell,,,2,1,3,43,0.000011
Evil-unveiled.com/Marthijn Uittenbogaard,,,5,2,7,43,0.000054
Evil-unveiled.com/Master of Puppets,,,2,3,5,43,0.000014
Evil-unveiled.com/Matt Wagner,,,2,2,4,43,0.000011
Evil-unveiled.com/Matthew Woodward,,,2,7,9,43,0.000011
Mattybear,,,3,15,18,8,0.000011
Evil-unveiled.com/Memnoch,,,4,1,5,43,0.000015
Evil-unveiled.com/Mi Ra Cle,,,3,2,5,43,0.000081
Evil-unveiled.com/Michael1016,,,3,6,9,43,0.000011
Evil-unveiled.com/Zkish,,,6,9,15,43,0.000016
Evil-unveiled.com/ZMan6919,,,18,5,23,43,0.000052
Evil-unveiled.com/Michael Price,,,7,3,10,43,0.00003
Evil-unveiled.com/Michael Resann,,,5,10,15,43,0.000022
Evil-unveiled.com/Simon Rose,,,3,2,5,43,0.000012
Evil-unveiled.com/Miguel Sanchez,,,7,8,15,43,0.000047
Evil-unveiled.com/Mike D78,,,2,1,3,43,0.000013
Evil-unveiled.com/Mikey,,,4,5,9,43,0.000037
Evil-unveiled.com/Mythbuster101,,,5,5,10,43,0.000038
Evil-unveiled.com/Moggychops,,,2,3,5,43,0.000011
Evil-unveiled.com/Montreal Ganymede Collective,,,15,13,28,43,0.00014
Evil-unveiled.com/Mortuis99,,,2,1,3,43,0.000011
Evil-unveiled.com/MrTim,,,5,2,7,43,0.000041
Evil-unveiled.com/My Silent War,,,3,2,5,43,0.000014
Evil-unveiled.com/NFiH,,,4,3,7,43,0.000087
Evil-unveiled.com/Nelson Garcia,,,1,3,4,43,0.000011
Evil-unveiled.com/Nelly,,,3,3,6,43,0.00004
Evil-unveiled.com/Nickless,,,3,2,5,43,0.000014
Evil-unveiled.com/Nifty,,,4,0,4,43,0.00004
Evil-unveiled.com/Nihil Aeturnius,,,3,2,5,43,0.000014
Evil-unveiled.com/NukeSheep,,,4,9,13,43,0.000049
Evil-unveiled.com/Nycalvin,,,2,2,4,43,0.000011
Evil-unveiled.com/Paul Gerard Dobbins,,,9,6,15,43,0.000022
Evil-unveiled.com/Viamund the Rake,,,1,2,3,43,0.000011
Evil-unveiled.com/OldStNik,,,1,3,4,43,0.000011
Evil-unveiled.com/Open Hands,,,12,4,16,43,0.000109
Evil-unveiled.com/Orpheus,,,3,2,5,43,0.000026
Evil-unveiled.com/Oscar Scott Guzman,,,2,5,7,43,0.000011
Evil-unveiled.com/PACE,,,4,1,5,43,0.000029
Evil-unveiled.com/PACM,,,4,6,10,43,0.00002
Evil-unveiled.com/Paiderastia,,,3,5,8,43,0.000014
Evil-unveiled.com/Partiboi26,,,2,2,4,43,0.000015
Evil-unveiled.com/Pat Kelly,,,5,2,7,43,0.000051
Evil-unveiled.com/Paul83,,,4,5,9,43,0.000018
Evil-unveiled.com/Sproutinghalo,,,2,1,3,43,0.000011
Evil-unveiled.com/Satan666,,,3,4,7,43,0.000013
Evil-unveiled.com/Psyco,,,2,4,6,43,0.000011
Evil-unveiled.com/Slvrspun,,,3,3,6,43,0.000016
Evil-unveiled.com/Ped0sapien,,,7,4,11,43,0.00002
Evil-unveiled.com/Pedophile Violent/Death Threats,,,2,10,12,43,0.000011
Evil-unveiled.com/Sibelius,,,4,1,5,43,0.000014
Evil-unveiled.com/Peter Christian,,,2,3,5,43,0.000051
Evil-unveiled.com/Peter Piper,,,3,1,4,43,0.000026
Evil-unveiled.com/Phantom-mode,,,1,2,3,43,0.000011
Evil-unveiled.com/Phillydude32,,,3,1,4,43,0.000012
Evil-unveiled.com/Pissimissi,,,3,2,5,43,0.000015
Evil-unveiled.com/PonyBoy,,,2,2,4,43,0.000015
Evil-unveiled.com/PopaBear,,,3,9,12,43,0.000031
Puellula,,,8,13,21,43,0.000057
Evil-unveiled.com/QT,,,1,3,4,43,0.000011
Evil-unveiled.com/Quicksand0420,,,2,3,5,43,0.000011
"Evil-unveiled.com/RSO Rally - Columbus, OH",,,1,3,4,43,0.000011
Evil-unveiled.com/Rahiim,,,1,2,3,43,0.000011
Evil-unveiled.com/Raimund Wild,,,2,2,4,43,0.000011
Evil-unveiled.com/Raindrop1703,,,3,2,5,43,0.000016
Evil-unveiled.com/Redpalm,,,3,1,4,43,0.000012
Evil-unveiled.com/Rebellee,,,1,5,6,43,0.000011
Evil-unveiled.com/Redirections,,,1,1,2,43,0.000011
Evil-unveiled.com/Reform Sex Offender Laws Campaign,,,22,18,40,43,0.000127
Evil-unveiled.com/Rhite,,,2,3,5,43,0.000011
Evil-unveiled.com/RightSexWrongSex.com,,,2,2,4,43,0.000011
Evil-unveiled.com/Ring Fan,,,1,1,2,43,0.000011
Evil-unveiled.com/Roar for Freedom,,,14,14,28,43,0.000063
Evil-unveiled.com/Robbie,,,3,4,7,43,0.00002
Evil-unveiled.com/Wabbit,,,3,1,4,43,0.000024
Evil-unveiled.com/Roderik Muit,,,2,4,6,43,0.000011
Evil-unveiled.com/Truthseeker,,,6,13,19,43,0.000024
Evil-unveiled.com/Sex Offender Support and Education Network,,,27,20,47,43,0.00011
Evil-unveiled.com/SOSEN Staff,,,2,8,10,43,0.000011
Evil-unveiled.com/SOclear Media Productions,,,21,18,39,43,0.000088
Evil-unveiled.com/SOhopeful International,,,19,6,25,43,0.000067
Evil-unveiled.com/Sure Quality Radio,,,23,20,43,43,0.000149
Evil-unveiled.com/SSDI Funded Pedophiles,,,2,6,8,43,0.000011
Evil-unveiled.com/SafeHaven,,,2,2,4,43,0.000035
Evil-unveiled.com/Santi,,,4,4,8,43,0.000016
Evil-unveiled.com/Soulfulsongbird,,,3,10,13,43,0.000012
Evil-unveiled.com/Scouter1807,,,1,1,2,8,0.000011
Evil-unveiled.com/Sean138666,,,2,2,4,43,0.000011
Evil-unveiled.com/Shirley Lowery,,,11,6,17,43,0.000038
Evil-unveiled.com/Shiver,,,1,3,4,43,0.000011
Evil-unveiled.com/Shotacon,,,2,0,2,43,0.00002
Evil-unveiled.com/Silver Wolfe,,,1,2,3,43,0.000011
Evil-unveiled.com/SkyeBoy,,,2,4,6,43,0.000011
Evil-unveiled.com/Somersault's Forums,,,10,3,13,43,0.000061
Evil-unveiled.com/Sparks,,,6,4,10,43,0.000034
Evil-unveiled.com/Starlet Luver,,,6,10,16,43,0.000051
Evil-unveiled.com/Stefanhulsberg,,,2,2,4,43,0.000018
Evil-unveiled.com/Stegl.info,,,2,4,6,43,0.000022
Evil-unveiled.com/WillyWonka,,,2,1,3,43,0.000011
Evil-unveiled.com/Steve d,,,3,2,5,43,0.000061
Evil-unveiled.com/Wzzzy,,,4,3,7,43,0.000014
Evil-unveiled.com/Supergirl,,,2,1,3,43,0.000011
Evil-unveiled.com/TMaximus95,,,11,15,26,43,0.000034
Evil-unveiled.com/Taf-kat,,,3,3,6,43,0.000025
Evil-unveiled.com/Technea,,,4,5,9,43,0.000023
Evil-unveiled.com/TeenBoysWorld,,,15,15,30,43,0.000075
Evil-unveiled.com/Terry Brown,,,2,0,2,43,0.000011
Evil-unveiled.com/The Fayla Incident,,,3,3,6,43,0.000077
Evil-unveiled.com/The Phantom,,,2,3,5,43,0.000014
Evil-unveiled.com/The Storyteller,,,5,7,12,43,0.000095
Evil-unveiled.com/Tom Reeves,,,6,5,11,43,0.000024
Evil-unveiled.com/Tim Merrigan,,,3,2,5,43,0.000011
Evil-unveiled.com/Tobs,,,5,5,10,43,0.00005
Evil-unveiled.com/Tom Madison,,,12,10,22,43,0.000045
Evil-unveiled.com/Trucker,,,2,4,6,43,0.000012
Tycho,,,5,3,8,43,0.000031
Evil-unveiled.com/Valerio,,,3,2,5,43,0.000017
Evil-unveiled.com/Vespucci,,,1,3,4,43,0.000011
Evil-unveiled.com/Walter Wesley Davis,,,1,2,3,43,0.000011
Evil-unveiled.com/White Falcon,,,2,2,4,43,0.000033
Evil-unveiled.com/Wikipedia Campaign,,,11,20,31,43,0.000056
Evil-unveiled.com/Wolfboi,,,2,2,4,43,0.000013
Evil-unveiled.com/Wolfman,,,5,5,10,43,0.000036
Evil-unveiled.com/Wolfy,,,3,2,5,43,0.000019
Evil-unveiled.com/Wu-k'ung,,,2,4,6,43,0.000024
Evil-unveiled.com/Xalex,,,4,9,13,43,0.000015
Evil-unveiled.com/Xanadu,,,2,1,3,43,0.000012
Evil-unveiled.com/Young friend,,,3,1,4,43,0.000014
Evil-unveiled.com/Zoozoo,,,2,1,3,43,0.000033
Evil-unveiled.com/Ninjaboy,,,2,4,6,43,0.000017
Evil-unveiled.com/BeachGuy,,,0,3,3,43,0.000011
Chadzboyz,,,1,0,1,43,0.000013
Chadzboys,,,1,0,1,43,0.000013
Evil-unveiled.com/Church of Jesus Among the Teachers,,,1,8,9,43,0.000012
Evil-unveiled.com/TylerP,,,3,1,4,43,0.000027
Joshua,,,4,25,29,19,0.000031
Evil-unveiled.com/Joe Schramer,,,4,2,6,43,0.000017
Kev,,,1,0,1,43,0.000014
Pandabear,,,1,0,1,43,0.000014
Spk,,,1,0,1,43,0.000014
Crake,,,1,0,1,43,0.000014
Zitellu,,,1,0,1,43,0.000014
Blumla,,,2,0,2,43,0.00002
Boyzparadise.net,,,1,0,1,43,0.000012
Lovedr101,,,1,0,1,43,0.000011
Visionary,,,1,0,1,43,0.000011
Merillorang,,,1,0,1,43,0.000011
Sans25a,,,1,0,1,43,0.000011
Mora,,,1,0,1,43,0.000011
Porzellan,,,1,0,1,43,0.000011
Grzyb,,,1,0,1,43,0.000011
Toolman,,,1,0,1,43,0.000011
Glystew,,,1,0,1,43,0.000011
Evil-unveiled.com/Leisa34f,,,2,1,3,43,0.000011
Evil-unveiled.com/Warrier22,,,2,3,5,43,0.000011
Cherihousewife,,,1,0,1,43,0.000011
Paedoheaven,,,1,0,1,43,0.000011
Evil-unveiled.com/Byteman2000,,,0,1,1,43,0.000011
Evil-unveiled.com/Cjgreen,,,3,5,8,43,0.000015
Evil-unveiled.com/Ckthecl,,,0,1,1,43,0.000011
Honesty,,,1,0,1,43,0.000014
Skylark,,,2,0,2,43,0.000019
Evil-unveiled.com/David Upton,,,0,1,1,43,0.000011
Evil-unveiled.com/Davidwr,,,3,5,8,43,0.000014
Girltales.com,,,7,0,7,43,0.000049
Evil-unveiled.com/Eric Risch,,,2,4,6,43,0.000013
Jeffsfortboard.com,,,1,0,1,43,0.000014
Kabouter,,,1,0,1,43,0.000024
Evil-unveiled.com/Jamesters,,,0,2,2,43,0.000011
Evil-unveiled.com/JonWesley,,,1,8,9,43,0.000011
Evil-unveiled.com/Josh,,,2,1,3,43,0.000031
Evil-unveiled.com/Kevin John Rose,,,1,1,2,43,0.000011
Lilmekim,,,1,0,1,43,0.000018
Evil-unveiled.com/Leo Kan,,,0,3,3,43,0.000011
Indigo,,,1,0,1,43,0.000027
Still young,,,1,0,1,43,0.000027
Evil-unveiled.com/MK-II,,,0,2,2,43,0.000011
Evil-unveiled.com/Mattybear,,,1,1,2,8,0.000011
Evil-unveiled.com/Mike,,,1,1,2,43,0.000011
Evil-unveiled.com/Minutemen,,,2,14,16,43,0.00002
Evil-unveiled.com/Shana Rowan,,,3,6,9,43,0.000021
Rudy101,,,2,0,2,43,0.000015
Evil-unveiled.com/Movieman,,,1,2,3,43,0.000011
Evil-unveiled.com/NAMBLA,,,1,5,6,43,0.000015
Evil-unveiled.com/Paul Shannon,,,2,5,7,43,0.000021
Evil-unveiled.com/Phil Phantom,,,1,2,3,43,0.000012
Evil-unveiled.com/Puellula.com,,,1,10,11,43,0.000014
Evil-unveiled.com/RSOL Signatories,,,1,5,6,43,0.000017
Evil-unveiled.com/Richie Wright,,,0,1,1,35,0.000011
Evil-unveiled.com/SKUV,,,1,4,5,43,0.000011
Poppadave,,,1,0,1,43,0.000012
Darwingl,,,1,0,1,43,0.000013
Evil-unveiled.com/Steve Choisser,,,1,5,6,43,0.000011
Evil-unveiled.com/Suzieq0805,,,0,2,2,43,0.000011
Scooterdude,,,1,0,1,43,0.000015
Whatevertrevor,,,1,0,1,43,0.000015
In2teens,,,1,0,1,43,0.000015
Boysaregreat1,,,1,0,1,43,0.000015
Redterrapin,,,1,0,1,43,0.000015
Bow,,,1,0,1,43,0.000015
Boyzoom,,,1,0,1,43,0.000014
WMCritest,,,3,21,24,48,0.000033
Asstr.org,,,1,0,1,43,0.000015
Evil-unveiled.com/Tycho,,,1,3,4,43,0.000019
Evil-unveiled.com/Tyciol,,,1,8,9,43,0.000012
Digitalemotion,,,1,0,1,43,0.000013
Evil-unveiled.com/Wolfy1619,,,0,1,1,43,0.000011
Genetic Sexual Attraction,,,1,27,28,42,0.000012
Evil Jacket Guy,,,2,14,16,26,0.000012
Evil Trout,,,1,13,14,41,0.000011
Evilzug,,,3,28,31,4,0.000021
Endgameradio,,,1,0,1,4,0.000011
LittleKuriboh,,,12,83,95,28,0.000056
Timeline of evolution,,,3,1,4,46,0.000013
ZabaSearch,,,4,11,15,8,0.000015
Kingory,,,3,12,15,49,0.000012
Ty Cobb,,,7,95,102,35,0.000021
Joy Division,,,5,34,39,12,0.000015
Ex-Raye,,,1,24,25,12,0.000015
ExaltGod,,,4,30,34,7,0.000015
SonicClone,,,3,20,23,46,0.000011
Starrceline,,,4,28,32,46,0.000013
Excitard,,,2,7,9,9,0.000014
L-L-LUNAJACK!,,,10,36,46,9,0.000029
"Excuse me, Commissar",,,4,8,12,9,0.000014
Exhibit B-5,,,3,11,14,48,0.000011
Exile.ru,,,2,24,26,41,0.000011
User:Jakesofresh/Counter troll,,,3,0,3,41,0.000011
ExilePitbull,,,2,25,27,35,0.000011
Existence,,,6,61,67,46,0.000043
ExoParadigmGamer,,,7,23,30,7,0.000013
HyperCharge,,,5,16,21,7,0.000013
ImageFap,,,10,36,46,63,0.000037
Experience Project,,,2,50,52,13,0.000012
Muteba Kidiaba,,,3,21,24,9,0.000014
Explosiv22,,,5,25,30,38,0.000012
Inane flame,,,11,11,22,41,0.000041
FAE Inc.,,,1,13,14,31,0.000011
FATAL,,,3,3,6,2,0.000011
FBI Informant,,,3,6,9,10,0.000018
FBI redirection,,,6,21,27,53,0.000049
I FUCKIN' LOVE COLORING!!!!!!,,,2,2,4,51,0.000011
Pussy Riot,,,8,32,40,37,0.000025
Hatedwerewolf,,,11,77,88,31,0.000031
Tegaki E,,,5,33,38,28,0.000013
Tori Belliachi,,,8,50,58,31,0.000012
FCYTravis/LiveJournal,,,1,1,2,2,0.000011
FFS,,,9,18,27,19,0.000026
UFIA,,,2,6,8,9,0.000013
FMA: Redemption,,,0,17,17,21,0.000011
FMS,,,0,3,3,41,0.000011
FPSRussia,,,1,24,25,17,0.000012
FTFY,,,1,5,6,19,0.000011
Gråtrunka,,,2,2,4,18,0.000013
Secret crush meme,,,4,9,13,8,0.000021
Raniko,,,4,78,82,31,0.000029
FUBU,,,1,5,6,35,0.000011
Lanturn,,,3,23,26,9,0.000013
Reader Rabbit,,,1,20,21,31,0.000011
FUNImation2002/Mr. Demon Slayer,,,1,23,24,15,0.000011
FUNImation2002/Jigglypuff (super smash bros.),,,2,6,8,13,0.000013
Fa/,,,0,75,75,63,0.000011
Fable,,,5,41,46,49,0.000014
Facebomb,,,2,4,6,9,0.000018
Facebook/Source,,,1,1,2,59,0.000015
Facebook Groups,,,9,32,41,59,0.000021
Sharecash DDoS,,,4,20,24,9,0.000013
Facebook Usernames 2009,,,3,12,15,24,0.000016
Grieving Jew,,,5,15,20,47,0.000019
User:LeftClicker/Verynicelady,,,2,0,2,49,0.000017
Facepunch TCG,,,3,15,18,27,0.000013
The Great Hack Of Facepunch,,,3,19,22,23,0.000011
Facepunch Studios/Dan Was Boobies: The Big Bomb story,,,0,31,31,41,0.000011
Facepunch Studios/Noteworthy events,,,1,23,24,0,0.000011
NephilimFree,,,32,29,61,46,0.00009
FaeTian,,,3,29,32,21,0.000029
I got married last weekend,,,7,28,35,56,0.000036
Fag trap,,,2,8,10,40,0.000011
Faggot in training,,,3,51,54,13,0.00002
Harrassment,,,1,0,1,13,0.000011
U-18Chan,,,5,42,47,31,0.000011
Sexlord66,,,5,57,62,52,0.000014
Sir Wulfington,,,3,53,56,7,0.000012
Romeo Rose,,,8,88,96,39,0.000022
Kyle Perkins,,,4,31,35,36,0.000012
Skinny Jeans,,,12,90,102,12,0.000027
Kathy Griffin,,,6,86,92,36,0.000022
Gerald Ford,,,6,7,13,17,0.000087
Red Shirt Guy,,,5,8,13,49,0.000017
Jude's Army,,,14,70,84,41,0.000034
ZDNet,,,2,6,8,10,0.000015
International Dan Sanders Day,,,2,20,22,52,0.000015
LateNightShots,,,5,51,56,0,0.000022
Luke Springett,,,2,19,21,26,0.000015
Multiply,,,4,18,22,12,0.000021
MyYearBook,,,5,39,44,12,0.000019
SoFlo,,,1,0,1,59,0.000015
Spike Zombie,,,4,23,27,52,0.000017
Swabez93,,,1,6,7,3,0.000015
Quentin Hubbard,,,4,15,19,26,0.000038
Minimalism,,,5,23,28,10,0.000019
Themaskedanalyst,,,15,44,59,48,0.000019
Saturnine Films,,,8,45,53,46,0.00002
Fake LJ deaths,,,3,15,18,8,0.000012
Grindr,,,6,25,31,40,0.000018
Pet,,,2,5,7,25,0.000013
Torah,,,5,8,13,17,0.000021
Octopus,,,3,5,8,9,0.000013
Roger Ebert,,,7,16,23,34,0.000014
Wikipedia Hoaxes,,,6,19,25,2,0.000029
Fake Schizophrenia,,,3,20,23,30,0.000016
Fake Your Space,,,3,27,30,12,0.000019
Lord Rexington Fear,,,10,24,34,52,0.000023
Publicgirluk,,,7,10,17,2,0.000024
Fuckkk everyone,,,3,9,12,41,0.000015
Rape man,,,2,4,6,8,0.000015
Faking News,,,4,11,15,14,0.000014
Falconlobo,,,2,47,49,21,0.000011
Shut up and take my money,,,1,19,20,9,0.000011
XxMisery-SeverityxX,,,2,6,8,19,0.000011
Fallout: Shadow of Boston/Perks,,,0,94,94,19,0.000011
Fallout: Shadow of Boston/SandraReed,,,0,2,2,5,0.000011
Fallout Online,,,0,30,30,49,0.000011
Starfield,,,1,15,16,49,0.000011
Family Guy Funny Moments,,,2,13,15,53,0.000016
Yomama,,,3,23,26,34,0.000031
Media Slayer Productions,,,4,7,11,7,0.000027
"TWILA, DA GIRL WHO WAS IN LUV W A VAMPIR",,,2,15,17,32,0.000015
My Inner Life,,,3,71,74,32,0.000015
The Liliad,,,2,11,13,9,0.000014
Silver seren,,,11,58,69,2,0.00002
Whitedog1,,,5,60,65,21,0.000014
Fan History,,,2,22,24,21,0.000016
WTF Fanfiction,,,2,5,7,21,0.000014
Songfic,,,2,7,9,28,0.000019
Kameko,,,1,8,9,35,0.000011
Sensitive,,,10,6,16,61,0.000029
Undesirable Number One,,,2,44,46,6,0.000011
TV Tropes/Horrible Fanfics,,,4,12,16,2,0.000012
FanFiction/examples,,,0,5,5,28,0.000011
Fanlistings,,,1,7,8,5,0.000012
Fanpop,,,3,24,27,36,0.000016
Ralph Pootawn,,,8,13,21,7,0.000022
FlappyBird,,,4,20,24,19,0.000014
Kerbal Space Program,,,4,50,54,46,0.000013
Tilde,,,8,21,29,28,0.000031
Scott Pilgrim vs. the World,,,10,41,51,12,0.000021
Mandaswaggie,,,2,8,10,12,0.000017
MissKnowItAll,,,4,32,36,24,0.000016
VegetaWorshipper,,,6,48,54,47,0.000035
Minami-Kousaka,,,3,8,11,28,0.000017
Fantendo,,,1,84,85,61,0.000011
Harassing,,,1,0,1,61,0.000011
Special:ListUsers/sysop,,,4,0,4,23,0.000013
Fantreasureplanetljs,,,0,1,1,21,0.000011
Knife Game,,,4,27,31,58,0.000027
Healthy Strokes,,,6,14,20,18,0.000028
Sperm Donation,,,4,8,12,18,0.000027
Just Cause,,,1,30,31,49,0.000011
Far Cry 5,,,2,69,71,49,0.000011
Figure Collecting,,,4,18,22,7,0.000012
Farfour,,,3,11,14,37,0.00002
IMDb message boards,,,3,29,32,44,0.000015
Magua,,,6,15,21,34,0.000014
Farrah Abraham,,,0,11,11,36,0.000011
Fart Rape,,,3,11,14,39,0.000012
Fast Eddie,,,6,40,46,2,0.000012
War Thunder,,,5,69,74,49,0.000015
Mikevirus,,,2,26,28,10,0.000011
Grape Lady,,,1,16,17,32,0.000029
Missalyssum,,,2,6,8,11,0.000029
Kirstie Alley,,,7,15,22,26,0.000036
Krispy Kreme,,,3,32,35,15,0.000029
Kylie Lannigan,,,2,12,14,52,0.000029
Katiethesinger123,,,2,25,27,52,0.000029
Tofer,,,5,31,36,31,0.00003
The Biggest Loser,,,2,15,17,52,0.000029
Liz Shaw,,,5,246,251,59,0.000033
Fat30,,,2,13,15,1,0.000011
FatQuack,,,1,76,77,23,0.000011
Texturefag,,,4,60,64,19,0.000012
Thesugarmonster,,,3,33,36,52,0.000017
Project Harpoon,,,6,71,77,52,0.000016
NAAFA,,,1,7,8,52,0.000012
Wikipedia's Greatest Hits Racism,,,3,7,10,2,0.000013
Manatee-chan,,,3,21,24,52,0.000017
Squee,,,5,12,17,28,0.000018
Karaokeplay,,,2,6,8,29,0.000012
Le wrong generation,,,2,97,99,12,0.000012
Mark,,,1,29,30,26,0.000012
Trevor Noah,,,3,16,19,17,0.000015
Nathan Gale,,,4,26,30,40,0.000013
House Of Lulz,,,3,18,21,37,0.000012
Imagine Dragons,,,2,13,15,12,0.000012
Macklemore,,,4,25,29,40,0.000013
XXXTentacion,,,2,5,7,12,0.000012
Name my band,,,1,31,32,9,0.000012
Latexfox,,,3,13,16,31,0.000012
Melody the Phoenix Daimon,,,3,38,41,31,0.000011
Fat son,,,4,34,38,9,0.000021
Yariman,,,3,24,27,28,0.000017
OMGWTFOTL,,,5,23,28,28,0.000017
Fatemeh Khavari,,,0,33,33,19,0.000011
Pseudonym,,,1,0,1,52,0.000011
Here come the lulz,,,1,0,1,52,0.000011
Melinda Lyons-Marquez,,,3,9,12,27,0.000018
Retire,,,1,0,1,18,0.000011
Fay,,,0,3,3,40,0.000011
Faye,,,2,4,6,9,0.000014
Fbr trash,,,1,85,86,32,0.000011
Fearnor,,,3,16,19,10,0.000012
Gegabyte,,,1,63,64,7,0.000012
Felipeneto,,,2,36,38,32,0.000011
Fembusters/Jimmy Kimmel's Big Shillel,,,1,2,3,19,0.000011
Fembusters/Promotion,,,1,18,19,19,0.000011
Nerdy Fandom Gateway Theory,,,3,39,42,7,0.000012
Fembusters/AVGN,,,0,5,5,61,0.000011
Victimhood Industry,,,9,8,17,19,0.000033
Fembusters/Leslie Jones Getting Hacked,,,1,6,7,19,0.000014
Femitheist,,,5,8,13,19,0.000338
Plague Inc,,,7,102,109,37,0.00005
The Female Privilege Checklist,,,6,19,25,19,0.000024
Women's suffrage,,,4,10,14,39,0.000017
Politics and the city,,,1,19,20,36,0.000016
IHateMen,,,3,25,28,39,0.000016
RadFemSpeak.net,,,2,32,34,39,0.000016
SoSuave.net,,,4,20,24,39,0.000017
World of Longplays,,,6,45,51,61,0.000013
The Legend of Zelda: Breath of the Wild,,,1,39,40,49,0.000012
Feminist Frequency/501c3,,,1,0,1,19,0.000012
Feminist Hacker Barbie,,,1,17,18,19,0.000011
Shirtgate,,,3,2,5,19,0.000015
Fendippitous Eggmen,,,2,18,20,9,0.000014
Game Show,,,5,32,37,61,0.000013
Fernando Burtoni,,,1,38,39,31,0.000011
Kanadajin,,,4,53,57,28,0.000013
Partial Unbirthing,,,7,26,33,39,0.000046
Fidget spinner,,,5,26,31,7,0.000021
Train,,,14,12,26,36,0.000029
Gd/,,,5,14,19,9,0.000013
GOTTA GO FAST,,,14,0,14,49,0.000019
Right,,,9,4,13,36,0.00002
Lubbock,,,3,80,83,35,0.000014
Fifthnail,,,0,1,1,43,0.000011
It was my privilege,,,3,4,7,19,0.000016
Fighting game forums,,,2,41,43,49,0.000011
Super GAME OVER,,,4,33,37,63,0.000012
Figment,,,3,104,107,40,0.000011
Perfection Dolls,,,2,22,24,12,0.000011
Fikirtepe,,,2,40,42,57,0.000013
Delikanlı,,,1,0,1,57,0.000011
Filename thread,,,4,6,10,9,0.000012
Savage,,,4,9,13,7,0.000013
Parrotheads,,,4,44,48,0,0.000013
Sex by association,,,5,18,23,39,0.000023
The Moogle Cavern,,,7,49,56,31,0.000014
Quest 64,,,6,22,28,49,0.000017
Helm,,,1,61,62,15,0.000012
Rubeus Eden,,,7,109,116,28,0.000027
Isaac Hayes,,,4,14,18,35,0.000013
Gather Against Fate,,,8,79,87,19,0.000013
Final Fantasy XV,,,1,15,16,29,0.000011
Final Solution,,,0,21,21,46,0.000011
Finding Forrester,,,1,10,11,9,0.000011
Finger Box,,,2,18,20,9,0.000011
Joshwa Plastic,,,5,36,41,40,0.000013
IRC-Gallery,,,4,44,48,41,0.000013
Johanna Tukiainen,,,2,31,33,26,0.000012
Markorepairs,,,1,25,26,7,0.000012
Firas Alkhateeb,,,2,18,20,14,0.000011
Owl City,,,6,70,76,12,0.000021
Firefox Performance,,,1,5,6,2,0.000012
Safari XPS Attack,,,4,11,15,41,0.000018
Firithfenion,,,3,50,53,51,0.000016
HelLA,,,6,35,41,35,0.000015
Oppression Hierarchy,,,1,7,8,19,0.000011
Max Harris,,,4,20,24,12,0.000014
Flirty The Fox,,,6,36,42,21,0.000027
Xenosaga,,,4,31,35,28,0.000012
We bought bread together,,,2,15,17,9,0.000012
Sociology,,,6,34,40,14,0.000017
Fitna,,,6,54,60,37,0.000019
GOG,,,2,8,10,19,0.000011
Homocide,,,4,7,11,7,0.000013
The ED Civil War,,,7,82,89,26,0.00002
Tentacle Grape,,,4,4,8,28,0.000019
Flabbinabbal,,,0,11,11,8,0.000011
Nocturnus Libertus,,,1,19,20,7,0.000013
Flagged revisions,,,1,20,21,2,0.000011
Steering,,,3,26,29,8,0.000022
Tag Team,,,5,7,12,41,0.000021
Thread Occupation,,,4,6,10,41,0.00002
Vulture,,,1,5,6,41,0.00002
Resurrection,,,3,13,16,9,0.000021
The Throw,,,4,24,28,41,0.000021
Inciclopedia,,,8,41,49,2,0.000027
FlaminFire2252,,,0,22,22,21,0.000011
Flaming Atom Forums,,,1,3,4,46,0.000011
Ross Lumbus,,,2,29,31,24,0.000011
Flare183,,,1,10,11,39,0.000011
New,,,1,0,1,4,0.000012
Lolitrolu,,,1,0,1,4,0.000012
StickDeath,,,5,14,19,4,0.000014
Scott Bateman,,,1,17,18,4,0.000012
Hypercam,,,2,12,14,13,0.000013
FlashFlashRevolution,,,2,72,74,53,0.000011
FlatChan/Lolicon is illegal,,,3,7,10,41,0.000026
FleetCOMM,,,2,18,20,19,0.000011
Flippy X Flaky X Splendid,,,1,15,16,28,0.000011
Flockdraw,,,0,4,4,37,0.000011
Pikabellechu,,,2,25,27,28,0.000013
Libertarian Fox,,,6,19,25,31,0.000015
The Florida Tweenie Rapists,,,6,42,48,39,0.000017
Flower2563,,,3,15,18,7,0.000027
Floyd Lee Corkins,,,0,33,33,39,0.000011
Sweet Cakes,,,1,40,41,39,0.000011
Southern Poverty Law Center,,,5,9,14,19,0.000016
The Noid,,,1,10,11,52,0.000011
Fluffah,,,1,28,29,7,0.000011
Nexus-Fan-Of-Taismo,,,1,32,33,7,0.000011
Fluffy teh wolf,,,7,38,45,19,0.000028
Fluttershyrules5,,,0,22,22,7,0.000011
Fluxblog,,,2,5,7,6,0.000023
Rachel Corrie,,,16,59,75,37,0.000032
Fofl,,,3,6,9,9,0.000018
Folding@Home,,,1,4,5,49,0.000026
Folklore,,,1,127,128,39,0.000011
Killfilter,,,1,0,1,41,0.000012
Merrill Howard Kalin,,,1,23,24,1,0.000013
Jar Jar Binks,,,11,4,15,33,0.000021
TheWondersOfNatureNZ,,,3,18,21,39,0.000012
Moonbase Alpha,,,5,8,13,17,0.000023
For the evulz,,,3,17,20,1,0.00006
Forbes,,,3,1,4,17,0.000022
Forbidden,,,1,18,19,35,0.000011
Raptard,,,2,14,16,9,0.000014
Clock guy,,,2,0,2,9,0.000014
Green Lex Luthor,,,4,15,19,9,0.000016
He has no style,,,2,18,20,9,0.000014
Kristopher,,,1,51,52,52,0.000014
Midnight BBQ,,,5,54,59,9,0.000019
Not Internet Relevant,,,5,55,60,2,0.00004
Saint Patrick's Door,,,2,14,16,9,0.000015
Sock Person,,,7,41,48,26,0.00003
Sugar We're Going Down,,,7,20,27,9,0.000022
Sungle Jungle,,,3,14,17,19,0.000014
We Are Number One,,,2,9,11,9,0.000014
Wew Lad,,,3,7,10,9,0.000015
Zozzle,,,2,11,13,9,0.000017
Foresight FOB,,,1,3,4,9,0.000011
Coyote Ugly,,,1,0,1,17,0.000012
Sex In Christ,,,8,38,46,46,0.000012
Hueg,,,9,2,11,49,0.000014
Katefan0,,,4,4,8,2,0.000013
Moreschi,,,5,19,24,2,0.000012
Persian Poet Gal,,,11,11,22,2,0.000016
Jtkiefer,,,2,8,10,2,0.000011
General Discussion,,,4,48,52,11,0.000019
HEYITSKYLEE,,,2,41,43,13,0.000011
Jason Rodriguez,,,4,15,19,58,0.000013
Fortran,,,0,3,3,47,0.000011
Fortune DaHusky,,,3,6,9,31,0.000011
Xander Van Dam,,,5,14,19,31,0.000013
GTAForums,,,4,51,55,40,0.000016
Mygnrforum,,,3,67,70,0,0.000013
Neodrama,,,4,37,41,52,0.000014
Otaku Studios,,,2,10,12,0,0.000013
Ph33rforums,,,2,40,42,24,0.000013
Semiotic,,,1,37,38,37,0.000013
Insane Zero,,,2,60,62,20,0.000013
Forum COINTELPRO Techniques,,,9,6,15,41,0.000013
Netiquette,,,6,4,10,41,0.000025
Forunlawfulck,,,6,53,59,8,0.000011
Recommendation,,,3,1,4,8,0.000012
Political communities,,,3,8,11,8,0.000013
The Not-So-Great Syringe Meme of 2005,,,7,20,27,8,0.000024
Forza Motorsport 4,,,1,4,5,9,0.00002
Paranoid schizophrenia,,,1,0,1,46,0.000012
Gangstalking,,,1,0,1,46,0.000012
Space mermaid,,,1,0,1,46,0.000012
Four Loko,,,4,20,24,35,0.000016
FouseyTUBE,,,6,31,37,41,0.000019
Foxconn,,,6,16,22,10,0.00002
Foxler Nightfire,,,1,13,14,37,0.000011
Foxon,,,3,76,79,31,0.000011
Foxon/Journals,,,1,0,1,31,0.000011
FoxyFoxChick,,,6,62,68,41,0.000027
"‎Myah Walker",,,1,0,1,41,0.000011
Her-dark-prince,,,4,71,75,21,0.000012
WarpMyMind.com,,,11,26,37,22,0.000038
Fraggle,,,1,4,5,48,0.000014
Fran Ingram,,,1,10,11,59,0.000014
Zinedine Zidane,,,9,20,29,60,0.000017
Remi Gaillard,,,4,12,16,41,0.000016
Orangina,,,8,22,30,31,0.000016
Totally Spies,,,6,42,48,38,0.000026
Frank Bonafede,,,8,71,79,52,0.000013
Frank D. Henry,,,3,35,38,26,0.000014
Frank'sVoice,,,14,16,30,46,0.000022
Frank teh Goat,,,5,9,14,8,0.000012
Frank the Goat,,,4,18,22,8,0.000017
Lawnmower,,,2,0,2,0,0.000011
ShockOfGod,,,10,30,40,46,0.000019
TruthfulChristian,,,14,32,46,46,0.000021
YouLoveMolly,,,20,48,68,46,0.000027
FrankJavCee,,,0,1,1,48,0.000011
Sand,,,7,6,13,37,0.000023
Skinny reality,,,3,8,11,52,0.000016
Walmart Employee Suicide,,,4,16,20,58,0.000013
Same Face Syndrome,,,1,10,11,21,0.000012
Frank Limon,,,1,12,13,36,0.000011
Franks,,,1,2,3,8,0.000011
Fraps,,,3,11,14,10,0.000012
Freckle Chan,,,4,26,30,9,0.000012
Fred (disambiguation),,,1,12,13,35,0.000012
Vistaprint,,,2,9,11,10,0.000015
FreeSpace 2,,,0,1,1,49,0.000011
Free Bleeding,,,2,17,19,39,0.000012
Free Cupholder,,,2,17,19,10,0.000012
Server admin,,,3,6,9,31,0.000013
SubSeven,,,5,26,31,10,0.000015
Gary Freeman,,,5,31,36,31,0.000015
Freedom74,,,3,35,38,41,0.000016
Gaza War,,,13,87,100,37,0.000032
Flashmob,,,1,0,1,37,0.000011
Pedopals,,,14,24,38,53,0.000132
Freeko,,,2,43,45,12,0.000011
Freelancerraiko,,,3,71,74,7,0.000011
Freeman's Mind,,,3,22,25,49,0.000012
Freenode/Fastlizard4 captures,,,1,0,1,41,0.000013
Good job opers,,,7,4,11,41,0.000018
Kunwon1,,,3,4,7,41,0.000013
PZ Myers,,,3,19,22,46,0.000012
Tauriq Moosa,,,5,12,17,19,0.000013
Sinks,,,1,0,1,0,0.000011
IDrama,,,2,11,13,8,0.000015
Frienditto/Advicefrienditto,,,1,5,6,8,0.000015
Friendly Atheist,,,0,27,27,46,0.000011
Friends Reunited,,,2,17,19,40,0.000012
Friends cut,,,2,5,7,8,0.000012
James Leshkevich,,,4,39,43,35,0.000013
WWII Online,,,4,39,43,37,0.000016
Friendship is Witchcraft,,,0,17,17,7,0.000011
Fro0tlo0p,,,6,10,16,8,0.000021
Frivolous LJ Abuse Reports,,,2,15,17,8,0.000021
Lancerboi,,,2,6,8,8,0.000014
Ssidhu82,,,3,11,14,8,0.000016
Front Mission 5,,,2,71,73,49,0.000012
Nationalist,,,1,0,1,49,0.000011
Front page fags,,,3,60,63,9,0.000021
Nasty sex,,,5,14,19,31,0.000013
Frozentale,,,0,1,1,42,0.000011
Fuck.org,,,1,10,11,41,0.000013
Fuck Arabs,,,1,12,13,8,0.000016
GivesMeHope,,,3,19,22,1,0.000011
GroupHug,,,7,30,37,1,0.000013
SixBillionSecrets,,,4,26,30,1,0.000012
Nullface,,,3,6,9,9,0.000011
MyLifeIsAverage.com,,,3,19,22,11,0.000013
Rape Rodent,,,12,18,30,9,0.000043
Niggaz Wit Attitude,,,3,20,23,35,0.000012
Fuck for Forest,,,5,7,12,39,0.000012
Fuck off retard,,,2,1,3,35,0.000011
Pud,,,1,6,7,14,0.000011
A2m,,,1,0,1,14,0.000011
FuckingFurries,,,1,30,31,13,0.000011
Lougara,,,4,24,28,31,0.000028
Pre Med,,,1,65,66,46,0.000027
Hueg.pl,,,6,6,12,41,0.000033
Fully sick,,,6,24,30,40,0.000033
Goldenplate,,,4,25,29,46,0.000013
Wickerpedia,,,7,6,13,2,0.000019
Oz Kangaroo,,,4,20,24,31,0.000013
The Great FurAffinity Exodus of 2006,,,5,20,25,31,0.000013
FurFest Northwest,,,3,3,6,31,0.000011
FurNation,,,4,45,49,31,0.000015
My Little Pony Arena,,,10,50,60,7,0.00002
Furnet/Jewbacca logs,,,2,0,2,48,0.000012
Winged-Maniac,,,3,48,51,28,0.000012
Furcadia/Finances,,,1,1,2,31,0.000011
Qix,,,3,25,28,31,0.000011
Kique7,,,5,54,59,31,0.000027
Housepets!,,,3,42,45,31,0.000044
Johaan-N,,,1,21,22,31,0.000027
Princesswolfgirl,,,5,72,77,21,0.00003
Talamajic,,,4,11,15,36,0.000028
Vixen T. Fox,,,3,19,22,30,0.000027
Widdywoodpecker,,,7,52,59,21,0.000027
Furry Beach,,,5,14,19,31,0.00009
Human pups,,,5,28,33,40,0.000037
Rape Womble,,,4,46,50,17,0.000027
Typhon,,,2,24,26,31,0.000013
Morgan-the-Rabbit,,,3,43,46,21,0.000011
Furry-Furry,,,10,15,25,31,0.000014
Kathera Lockharte,,,9,46,55,31,0.00003
Furry Army of Doom,,,4,36,40,31,0.000011
Furry Fopsy,,,5,46,51,31,0.000011
DoDeDo,,,2,0,2,31,0.000012
Mushi Crosshairs,,,3,22,25,21,0.000012
Snapesnogger/Gallery,,,3,15,18,21,0.000013
Zeriara/archive 1,,,5,72,77,21,0.000017
RAPE APE,,,5,24,29,1,0.000016
Furtopia,,,7,9,16,31,0.000012
Supercutefurri,,,6,1,7,31,0.000013
Future the rapper,,,1,16,17,12,0.000011
Cellophane01,,,1,0,1,10,0.000011
Zero Cool,,,4,10,14,10,0.000013
Fyrerii,,,2,29,31,52,0.000013
G-Zay/A response by G-Zay,,,1,4,5,53,0.000011
HostGator,,,6,32,38,10,0.000016
G0sm0k3ashotgun,,,2,42,44,41,0.000011
Cutslikedrugsx,,,1,0,1,41,0.000011
G2g,,,3,10,13,3,0.000015
Wikichan/Sleeping Together,,,1,0,1,3,0.000015
GABYAW,,,0,8,8,8,0.000011
GET/Pre 100M,,,3,31,34,9,0.000013
GET/Post 100M,,,2,32,34,9,0.000012
"Pettan, pettan, tsurupettan",,,5,10,15,9,0.000022
GIGO,,,1,4,5,10,0.000042
GIYUS,,,3,5,8,26,0.000031
Strong,,,1,0,1,10,0.000011
GNU Social,,,0,38,38,14,0.000011
GOBBLES,,,10,32,42,10,0.00002
The Unix Terrorist,,,2,2,4,41,0.000015
GODOLOGY,,,4,5,9,46,0.000013
Novell,,,6,41,47,10,0.000019
GSCentral,,,2,18,20,10,0.000011
RJ Bandsma,,,6,52,58,7,0.000015
San Andreas Roleplay,,,6,166,172,54,0.000014
GTA Myths Wiki,,,0,20,20,2,0.000011
Gab.ai,,,5,10,15,19,0.000017
Gabberstagged,,,0,50,50,7,0.000011
Gabrielle Chana,,,6,61,67,51,0.000045
Gadi Evron,,,4,32,36,10,0.000013
Gaelic,,,2,6,8,37,0.000014
Silkroad Online,,,5,72,77,49,0.000015
Queen Of Dorks,,,5,33,38,21,0.000026
Legend of Aurea,,,2,18,20,47,0.000013
Myminicity,,,1,14,15,0,0.000013
Nurse Sezwick,,,2,40,42,8,0.000013
Prommie,,,4,2,6,8,0.000015
Gaijin Goombah,,,2,9,11,48,0.000011
Galaexe,,,0,4,4,19,0.000011
Gallantmon8,,,10,100,110,21,0.000016
Online Sports Betting,,,7,57,64,23,0.000013
Representation,,,1,0,1,49,0.000012
Personal Message,,,2,26,28,64,0.000012
GameSpy,,,6,18,24,49,0.000014
Mtiller2006,,,1,14,15,61,0.000011
Quirkyloverosee,,,2,90,92,52,0.000012
Tales of Symphonia,,,3,229,232,60,0.000013
Gamefly,,,2,6,8,49,0.000011
GameguySX75,,,1,11,12,7,0.000011
Mega64,,,9,28,37,49,0.000016
Violentacrez,,,6,5,11,19,0.000015
Kitty0706,,,3,9,12,49,0.000014
GamingAllStarsGmod,,,0,1,1,49,0.000011
Generic article for gangstas,,,1,19,20,35,0.000014
Gang of Four,,,4,9,13,9,0.000012
GangstaElijah,,,4,24,28,48,0.000012
Ganja Yoda,,,1,4,5,9,0.000011
TR Wolf,,,4,42,46,31,0.000011
Gardenstatement,,,1,34,35,52,0.000011
Retard-Pokefags,,,1,0,1,31,0.000011
Nicochi,,,8,64,72,15,0.00004
Garry's Mod/Expression 2 Scripts,,,1,0,1,49,0.000012
Gary,,,0,16,16,37,0.000011
Gary Kirk,,,3,35,38,2,0.000012
Gary McKinnon,,,9,57,66,37,0.00002
Gary Lineker,,,0,1,1,34,0.000011
Jacqui Smith,,,9,48,57,37,0.000018
Gary Oak/Copypasta,,,3,0,3,9,0.000013
Gather,,,2,21,23,3,0.000017
Guild,,,3,6,9,49,0.000011
Peter Thiel,,,4,11,15,19,0.000016
GayGamer,,,3,15,18,40,0.000011
Imclosetfree,,,3,7,10,40,0.000011
Gay Nigger Association of America/Victories,,,1,73,74,41,0.000011
Selery,,,3,9,12,2,0.000017
Teresa Cooper,,,1,24,25,39,0.000012
YouTube Rape Video,,,5,46,51,39,0.000037
Ravished,,,1,0,1,40,0.000012
Gazarooster,,,3,10,13,9,0.000011
NotCoolClub,,,3,14,17,9,0.000019
Morocco,,,3,14,17,37,0.000017
Gek,,,2,12,14,41,0.000027
Gweeds,,,5,16,21,41,0.000025
Indymedia,,,5,16,21,14,0.000026
Goo girl,,,8,12,20,28,0.000018
Gendergap,,,4,20,24,2,0.000013
MoodBar,,,4,1,5,2,0.000017
Overclocked ReMix,,,6,112,118,41,0.000014
Gene,,,0,7,7,41,0.000011
Gene Turnbow,,,7,11,18,41,0.000016
Susan Fox-Davis,,,3,9,12,41,0.000013
GenerationSlayer,,,2,4,6,13,0.000024
GenerationSlayer/arbchat,,,1,1,2,13,0.000016
Kyler Prescott,,,1,15,16,19,0.000012
Milo Stewart,,,6,33,39,19,0.000016
Learn the difference,,,7,97,104,19,0.000027
The Comprehensive Guide To Life,,,14,250,264,13,0.000048
Generic Flareon,,,1,46,47,31,0.000011
Self-troll,,,8,4,12,41,0.000012
Son,,,2,0,2,37,0.000012
Jack White,,,2,22,24,12,0.000012
Gengar-for-ever,,,3,74,77,21,0.000011
GengarPunk95,,,0,6,6,46,0.000011
Snowpuff77,,,1,11,12,46,0.000012
Waha,,,9,10,19,9,0.000039
Professor Layton,,,6,89,95,4,0.000018
Linkaton Furaito,,,7,53,60,38,0.000014
GeodesicDragon2k8,,,2,37,39,49,0.000011
George,,,1,17,18,35,0.000012
George Lincoln Rockwell,,,1,4,5,37,0.000011
Where's George?,,,5,13,18,37,0.000025
Macaca,,,2,32,34,14,0.000012
George Rekers,,,1,6,7,40,0.000011
Rentboy,,,2,15,17,40,0.000012
George Sodini/Blog,,,1,20,21,19,0.000011
George Stinney,,,0,2,2,50,0.000011
George Takei,,,3,49,52,19,0.000011
Skittles,,,1,0,1,35,0.000011
Neknominate,,,5,18,23,59,0.000016
Georgewilliamherbert,,,3,4,7,2,0.000011
Weefek,,,3,5,8,6,0.000013
Gerald Celente,,,1,12,13,3,0.000011
Gerard Butler,,,6,18,24,36,0.000016
Gerbilsage,,,4,10,14,8,0.000018
Schlager,,,1,23,24,36,0.000016
Gersh Kuntzman,,,2,49,51,17,0.000012
Get A New Daddy,,,3,14,17,48,0.000012
Nest Of Vipers,,,5,18,23,9,0.000017
Get On My Horse,,,2,14,16,44,0.000011
Mammy,,,7,25,32,9,0.00002
Getfirefox,,,2,16,18,10,0.000012
Getoffmyspace,,,2,60,62,8,0.000015
Open membership,,,3,5,8,8,0.000012
Maureen,,,3,9,12,53,0.000012
Lefty Begone,,,1,24,25,7,0.000011
Thizz,,,2,1,3,35,0.000013
Ghost World,,,0,4,4,12,0.000011
Thong,,,1,0,1,28,0.000011
Is it Ghostbusters 2?,,,9,16,25,41,0.000017
Giant Thumbs,,,4,14,18,49,0.00002
Gif war,,,4,14,18,9,0.000028
Giggy,,,2,10,12,2,0.000011
Gigi,,,4,2,6,49,0.000011
Gigli,,,3,15,18,39,0.000011
GillPanda,,,3,47,50,28,0.000011
Gimme Pizza,,,5,27,32,6,0.000015
Yakety Sax,,,6,42,48,37,0.000017
Gimps Gone Wild,,,4,5,9,39,0.00003
Gina Rinehart,,,1,39,40,17,0.000011
Ginger Genocide,,,5,20,25,37,0.000021
Gintama,,,2,21,23,28,0.000011
Girl Scouts,,,3,27,30,21,0.000033
Girl IRL,,,1,14,15,4,0.000011
Identifying A Guy IRL on Second Life,,,3,91,94,4,0.000013
Web traffic,,,4,10,14,8,0.000016
Minax,,,2,4,6,7,0.000012
Wylona Hayashi,,,3,9,12,7,0.000012
Significant other,,,10,26,36,27,0.00005
Irreverence,,,1,9,10,8,0.000012
Girlvinyl/Emails,,,2,3,5,52,0.000026
Tamageddon,,,1,6,7,52,0.000021
Motivator,,,1,0,1,9,0.000012
Giskard,,,2,8,10,49,0.000011
Gizoogle,,,5,4,9,10,0.000017
GlassBeadGame,,,2,5,7,2,0.000011
Glenn,,,0,5,5,25,0.000011
Glenn Taylor,,,3,16,19,26,0.000014
Analingus,,,1,0,1,14,0.000013
Glocktalk,,,4,28,32,3,0.000021
Wingsnugs,,,2,11,13,31,0.000012
Lolergasm,,,1,0,1,40,0.000013
Inheritance,,,3,54,57,32,0.000012
The Vagina Ass of Lucifer Niggerbastard,,,4,15,19,6,0.000011
Kevin Trudeau,,,7,17,24,26,0.000019
Glory Hole Foundation,,,0,10,10,41,0.000011
Rubber Johnny,,,4,18,22,38,0.000025
Sec Check,,,7,40,47,26,0.000014
HISTORY of the UNIVERSE,,,2,9,11,26,0.000011
Rightpedia,,,6,26,32,2,0.000014
Legacy Universe,,,2,22,24,1,0.000016
GodTube,,,2,17,19,39,0.000012
MyChurch,,,2,10,12,39,0.000011
Pastor Steven Anderson,,,6,8,14,37,0.000021
God mode,,,0,2,2,1,0.000011
Rainbow Road,,,3,31,34,49,0.000011
Kraken,,,6,13,19,28,0.000017
GoddessMillenia/BlarghPM,,,1,1,2,47,0.000011
GoddessMillenia/RLJPM,,,1,2,3,47,0.000011
GoddessMillenia/logs,,,1,2,3,47,0.000011
GoddessMillenia/Arbchat,,,1,2,3,47,0.000011
GoddessTrinity,,,9,15,24,26,0.000013
SkiFree,,,7,12,19,9,0.000033
Noxal,,,2,16,18,8,0.000012
Heisenberg Uncertainty Principle,,,4,35,39,46,0.00002
Dragon cock,,,1,0,1,34,0.000011
GoldenPalace.com,,,2,13,15,46,0.000012
Golden Road.net/Notable Quotes,,,0,17,17,7,0.000011
Jodie Gater and Stephanie Gestier,,,4,24,28,58,0.000017
Golden iPod/Nominees 2008,,,1,20,21,58,0.000011
Scout Schultz,,,5,131,136,19,0.000012
Perfect Dark,,,4,25,29,49,0.000015
TimeSplitters,,,2,97,99,49,0.000011
Goldfish,,,1,2,3,0,0.000012
Golimar,,,2,8,10,37,0.000013
Golliwogg,,,0,38,38,35,0.000011
Knife Control,,,1,31,32,37,0.000011
Gondola,,,1,15,16,9,0.000011
GoneGothic,,,3,49,52,12,0.000015
Life Is Strange,,,3,86,89,42,0.000026
Walking Simulator,,,2,19,21,19,0.000012
Gooby,,,1,13,14,12,0.000011
Tautogram,,,5,17,22,35,0.00002
Ircop,,,1,0,1,41,0.000015
Good spelling,,,2,14,16,3,0.000012
Steve Buscemi,,,5,5,10,9,0.000017
Goofykins,,,0,2,2,28,0.000011
Netscape Communicator,,,6,18,24,10,0.000017
Google Ultron,,,6,10,16,10,0.000019
Wikia Search,,,2,27,29,2,0.000013
Google Seppuku,,,4,7,11,3,0.000016
Google Translate,,,1,7,8,28,0.000016
Googlesux,,,3,10,13,10,0.000017
Googlewhacking,,,4,20,24,10,0.000017
Gordon,,,1,4,5,18,0.000012
Resident Evil 3,,,13,97,110,49,0.00004
Goregrish,,,4,48,52,24,0.000019
SEO,,,9,30,39,10,0.00002
Kaye Lazar,,,3,12,15,61,0.000012
Piss4400,,,1,38,39,61,0.000011
Gorgeous George/The Crologies of GG,,,2,141,143,61,0.000012
Gorgeous George/Allies of teh Fat,,,2,61,63,61,0.000011
Gorgeous George/List of LOLsuits,,,2,54,56,61,0.000011
Gorgeous George/Axis of teh Fat,,,1,18,19,61,0.000011
Gorgeous George/Gorgeous George and His TV Show,,,0,26,26,61,0.000011
Jonathon The Impaler Sharkey,,,3,19,22,53,0.000013
Shondaebrennan,,,3,19,22,61,0.000011
Montalk,,,8,27,35,17,0.000014
Gorilla warfare/Copypasta Archive,,,1,27,28,9,0.000014
GossipRocks,,,2,30,32,52,0.000019
Italian Spiderman,,,5,28,33,36,0.000016
Nick Cave,,,3,7,10,61,0.000016
The Sisters of Mercy,,,2,9,11,12,0.000015
LJ Lice Drama,,,2,3,5,22,0.000026
Gothguurl1989,,,3,30,33,56,0.000015
Lustifera,,,10,69,79,36,0.000024
Voodoo Devil Doll,,,6,85,91,21,0.000017
Mr. Bones' Wild Ride,,,2,15,17,19,0.000015
Genital warts,,,1,0,1,12,0.000011
See you in heel,,,5,10,15,9,0.000033
Strait jacket,,,1,0,1,22,0.000011
Yiffytube,,,4,12,16,40,0.000019
Invasion of privacy,,,1,0,1,9,0.000011
Puberty101,,,3,5,8,40,0.000012
NaNoWriMo,,,4,24,28,27,0.000015
Graal,,,2,18,20,12,0.000012
Maja Schmidt,,,1,53,54,48,0.000011
If it fits I sits,,,4,23,27,25,0.000013
Nicole Arbour,,,2,8,10,1,0.000011
Graeme Stephen Tucker,,,10,74,84,48,0.000021
Strategic exit,,,1,0,1,48,0.000011
Raveneagel,,,1,20,21,57,0.000018
Gran Turismo,,,1,7,8,49,0.000013
Grand Theft Auto III,,,2,43,45,1,0.000013
OG Loc,,,6,18,24,9,0.000014
Grand Theft Auto: Chinatown Wars,,,1,26,27,35,0.000011
Grand Theft Auto: Classics,,,0,16,16,58,0.000011
Grand Theft Auto: Liberty City Stories,,,0,3,3,27,0.000011
Grand Theft Auto: Vice City,,,0,18,18,35,0.000011
Graph,,,4,9,13,52,0.000024
JackAndSally4Ever,,,3,65,68,21,0.000012
Neo Arcane,,,4,60,64,21,0.000012
Steve MacIsaac,,,6,44,50,40,0.000013
Neomorphasis,,,3,44,47,21,0.000017
Penis Pump Sex Scandal '06,,,9,58,67,1,0.00002
Morgan Geyser & Anissa Weier,,,3,57,60,34,0.000012
Gravity Falls/Episode Guide,,,1,83,84,13,0.000011
Mr. Oompapa,,,5,20,25,2,0.000011
Great Mother,,,5,6,11,9,0.000023
Great Wall of Mexico,,,1,18,19,14,0.000012
Greatexpectations320/Arbchat,,,1,1,2,61,0.00002
Greatexpectations320/redsportscar321,,,1,1,2,61,0.000011
Mars Defden,,,7,58,65,32,0.000017
Pain in the ass,,,1,0,1,37,0.000012
Internet-IRL Warfare,,,2,12,14,3,0.000013
Sirius Orionis,,,7,61,68,31,0.000013
Thesmit,,,1,0,1,48,0.000011
Greg King,,,1,3,4,49,0.000011
"Hide, Ignore, Do Not Reply",,,5,15,20,9,0.000012
Greg Mazujian/Facebook Conversation,,,1,0,1,7,0.000011
ZenArcher,,,4,15,19,48,0.000012
Greg W Howard,,,1,24,25,14,0.000011
Grellfan98,,,2,12,14,7,0.000011
Greville Janner,,,6,67,73,17,0.00002
Neil Fox,,,2,15,17,17,0.000013
Greyson Chance,,,5,22,27,40,0.000012
World of Warcraft/Serenity Now,,,5,18,23,49,0.000016
Skittletouch,,,5,18,23,46,0.000012
IsItNormal,,,4,18,22,40,0.000011
Groupboard,,,2,82,84,28,0.000011
Mutant Cats,,,2,4,6,25,0.000016
Sonic Youth,,,10,42,52,12,0.00002
Guardian Of Virtue,,,3,7,10,27,0.000011
Guelph,,,3,54,57,35,0.000015
Guess The Meme/Gallery,,,1,0,1,9,0.000011
Guild Wars 2,,,3,18,21,49,0.000013
Writers Guild of America strike (2007),,,2,17,19,34,0.000013
John Mayer,,,2,22,24,0,0.000014
Guitarjono1170,,,0,18,18,38,0.000011
Pekiti,,,4,6,10,48,0.000014
Robert Bales,,,3,64,67,58,0.000015
Gunther,,,1,5,6,12,0.000011
Gunz,,,3,45,48,10,0.000012
GurigorloX,,,5,42,47,7,0.000012
King of Braves GaoGaiGar,,,3,161,164,28,0.000012
Prem Rawat,,,2,32,34,26,0.000014
Gutenberg Uncertainty Principle,,,0,14,14,3,0.000011
Guy Fawkes Day,,,2,27,29,9,0.000012
H-Dub Beeper,,,2,13,15,10,0.000013
H.J. Freaks,,,7,11,18,12,0.000013
H2O,,,1,38,39,35,0.000014
HA Animations,,,0,1,1,21,0.000011
HBalthamos,,,2,25,27,31,0.000011
Totally original,,,1,0,1,31,0.000011
HD Moore,,,0,40,40,1,0.000011
HIVchick,,,4,22,26,24,0.000011
HMO,,,8,20,28,21,0.000014
Steam Furries,,,7,32,39,31,0.000013
Nebris,,,5,50,55,8,0.000014
Horizontal scrollbar,,,2,1,3,53,0.000016
HTTP,,,3,10,13,2,0.000016
Nigras of Doom,,,2,18,20,1,0.000012
Habbo Coppers Raid of 2015,,,1,7,8,9,0.000012
Habbo Fansites,,,1,13,14,9,0.000013
The Great Habbo Raid of July 2010,,,3,40,43,9,0.000013
The Great Habbo Raid of July 2015,,,4,13,17,9,0.000016
Thelostcup,,,4,14,18,9,0.000015
The Palace,,,1,9,10,34,0.000013
Psg,,,1,20,21,0,0.000014
RIURichHomie,,,1,12,13,32,0.000014
Zone-H,,,2,4,6,10,0.000015
Hackerteen,,,3,25,28,41,0.000011
Hacking Exposed,,,1,13,14,10,0.000012
Device,,,1,0,1,10,0.000012
Michelle Phan,,,3,132,135,36,0.000011
Joanna Rutkowska,,,2,22,24,63,0.000011
Steve Gibson,,,3,56,59,10,0.000012
MR HAI,,,5,9,14,4,0.000016
Haiku,,,4,8,12,28,0.000014
Haitiguy,,,1,4,5,9,0.000011
Hal Turner 3807 shownotes,,,1,2,3,26,0.000012
MAC address,,,4,28,32,10,0.000017
Jerichoonly,,,4,39,43,26,0.000012
Kumichoo,,,6,23,29,32,0.000013
Hal Turner/Site Notice,,,2,1,3,6,0.000014
Halbreich.exe,,,1,1,2,2,0.000013
Yamanote Halloween Train,,,1,21,22,28,0.000011
Halsey,,,0,26,26,19,0.000011
Hammer (4chan Meme),,,1,6,7,9,0.000011
Jervaise brooke hamster,,,2,22,24,22,0.000015
Trona,,,2,13,15,35,0.000017
HandOfZek,,,1,39,40,28,0.000011
Hannah Crapps,,,4,25,29,3,0.000018
Unified Diversity,,,2,16,18,31,0.000012
Moviestr 20,,,3,21,24,1,0.000014
JasonRivera.com,,,6,18,24,15,0.000013
Hannah Sabata,,,0,5,5,12,0.000011
W0rmer,,,6,33,39,10,0.000018
Happy Madison Productions,,,0,4,4,19,0.000011
SheZow,,,3,21,24,19,0.000013
The Shining,,,5,1,6,19,0.000018
Happy Tree Friends Forum,,,2,87,89,62,0.000011
Pantera,,,9,42,51,40,0.000015
S-Malone,,,2,37,39,27,0.000011
Walter Palmer,,,3,13,16,19,0.000016
Hard Candy,,,4,33,37,13,0.000013
Anti-furry,,,1,0,1,31,0.000011
Urusei Yatsura,,,1,10,11,53,0.000013
Harlan Ellison,,,5,129,134,32,0.000019
Party Man,,,5,4,9,46,0.000017
Harlow Cuadra,,,3,18,21,40,0.000011
Sargon Quest,,,3,3,6,19,0.000068
Harrison Digfoot,,,1,18,19,56,0.000011
Harrumph!,,,1,3,4,9,0.000011
Wizard Rock,,,6,15,21,6,0.000018
Pottermore,,,4,40,44,44,0.000015
Laura Mallory,,,2,27,29,46,0.000018
Justine Sacco,,,5,16,21,19,0.000014
Hat,,,2,8,10,17,0.000013
Hate Speech,,,1,24,25,19,0.000014
Neologism,,,3,4,7,28,0.00002
ScarredFurry,,,4,28,32,31,0.000011
WolfAdvocate,,,7,61,68,31,0.000013
IS Defense,,,6,48,54,37,0.000012
Saints Row,,,8,35,43,49,0.000014
Hawkee,,,1,15,16,10,0.000011
MIRC,,,7,41,48,10,0.000018
Lifestyle,,,7,19,26,31,0.000026
Hayao Miyazaki,,,1,76,77,28,0.000011
Hayley Nightmare,,,3,19,22,13,0.000012
Rome Viharo,,,3,23,26,19,0.000013
He does it for free/logs,,,2,1,3,19,0.000017
Headswap,,,3,14,17,9,0.000013
Is chat dead?,,,4,6,10,41,0.000017
The Maze Runner,,,2,14,16,42,0.000011
How To Wash Your Hands,,,4,13,17,14,0.000016
Hearmenowu2,,,0,9,9,21,0.000011
Heartbleed,,,1,16,17,10,0.000012
Heartless Bitches International,,,3,31,34,39,0.000012
Heatenings,,,2,47,49,6,0.000012
Heath Campbell,,,3,29,32,37,0.000022
Heather Howland,,,4,20,24,39,0.000068
Mulderite,,,2,2,4,26,0.000012
Heavy Metal Gamer,,,0,25,25,12,0.000011
Heavy Rain,,,8,19,27,49,0.000015
Heavy The Squid,,,1,5,6,53,0.000011
Toby J Rathjen,,,3,16,19,7,0.000017
Heed My Warning,,,1,18,19,6,0.000014
Heed My Warning/Transcript,,,2,5,7,30,0.000011
Heed My Warning/Magical Aspie Circus of Funn,,,1,3,4,6,0.000011
Lionsgate Troll of 2006,,,5,30,35,30,0.000018
Hegel,,,7,45,52,14,0.000039
Heino Hijinks,,,2,20,22,56,0.000011
Klaus Barbie,,,1,15,16,37,0.000014
Helam,,,1,29,30,37,0.000011
Hella,,,0,8,8,47,0.000011
Hellkiller777,,,2,68,70,31,0.000011
Jan,,,4,7,11,43,0.000015
Hema,,,1,8,9,37,0.000015
White middle class liberal,,,3,32,35,14,0.000013
Henry Makow,,,2,85,87,17,0.000011
Simon Sheppard,,,10,126,136,37,0.000015
Hepday,,,2,18,20,41,0.000011
Herbivore,,,5,25,30,28,0.000022
Hermann Göring,,,0,8,8,37,0.000011
Hermie,,,1,27,28,31,0.000011
Hero Online,,,3,37,40,49,0.000014
In defense of slandered heroes,,,4,20,24,17,0.000017
HeroGaming,,,2,31,33,49,0.000011
Terraria,,,4,25,29,20,0.000012
Heron,,,1,1,2,12,0.000013
Herostratus,,,1,37,38,2,0.000011
Herro,,,1,22,23,31,0.000011
Nifty.org,,,4,7,11,31,0.000013
Jap trapboy gets fucked by horny 500 pound american neckbeard,,,1,0,1,37,0.000011
Non existant,,,1,0,1,40,0.000017
Hey Dad..!,,,2,11,13,59,0.000012
Sarah Monahan's Vagina,,,3,12,15,59,0.000013
Hibiscus-Lime,,,1,16,17,19,0.000011
KyrahChildFromFire,,,2,3,5,7,0.000012
High Five Harrison,,,1,4,5,21,0.000011
Mutsuo Toi,,,3,19,22,58,0.000021
Stockholm Truck Attack 2017,,,5,11,16,37,0.000016
Pandemic,,,3,33,36,35,0.000012
Sagamihara Stabbings,,,1,15,16,58,0.000011
Matthew de Grood,,,2,8,10,58,0.000012
High Score/Loserinfo,,,2,6,8,58,0.000012
Santa Fe High School Shooting,,,3,26,29,58,0.000013
Jason Dalton,,,4,28,32,58,0.000014
La Loch School Shooting,,,4,10,14,58,0.000015
Robert Butler Jr.,,,5,34,39,58,0.000013
James T. Hodgkinson,,,2,5,7,58,0.000012
Hitler Unit,,,1,1,2,58,0.000011
OMGMarly,,,2,29,31,21,0.000014
Hikaritail/Chat logs,,,1,1,2,1,0.000015
Hikaru no Go,,,3,23,26,28,0.000032
Just Fuck My Shit Up,,,3,11,14,19,0.000015
Hillary Clinton/Gallery,,,1,19,20,63,0.000013
Hinako Series,,,6,23,29,28,0.000041
HipForums,,,1,42,43,14,0.000011
Rootology,,,4,13,17,2,0.000015
Retro Video Game Kids,,,17,168,185,61,0.000028
The Keeper,,,4,44,48,27,0.000032
Treeman,,,2,12,14,9,0.000017
HiryuGouki,,,1,106,107,32,0.000011
Hitler: The Babe Within,,,0,17,17,26,0.000011
Hitler Top Tens,,,1,5,6,9,0.000011
Hitman,,,6,3,9,58,0.000014
Hockey Scores,,,2,25,27,3,0.000011
Hogan,,,1,6,7,15,0.000012
Nick Hogan,,,4,25,29,15,0.000014
Hol Tiger,,,4,25,29,31,0.000015
Metting,,,3,118,121,40,0.000012
Holeguy,,,2,35,37,9,0.000016
Hollie Greig,,,7,31,38,41,0.000013
Hollis Daniels,,,0,9,9,14,0.000011
James von Brunn,,,2,17,19,17,0.00002
Camp,,,1,0,1,14,0.000011
Homeless DJ,,,2,23,25,39,0.000015
Private School,,,2,35,37,58,0.000013
Michael Explicit,,,5,33,38,12,0.000035
Honest Abe,,,2,19,21,33,0.000011
Popcorn,,,3,53,56,31,0.000011
Hong Kong 97,,,0,13,13,49,0.000011
HopeStillFlies,,,0,24,24,19,0.000011
Horizon: Zero Dawn,,,0,50,50,39,0.000011
Horizontal,,,1,1,2,50,0.000012
Horny Pug,,,2,1,3,52,0.000011
I Hate Horses,,,5,26,31,31,0.000023
Latawnya,,,2,11,13,7,0.000017
Longhorse,,,6,8,14,31,0.00002
Sewer Horse,,,5,16,21,25,0.000021
Tim Sappington,,,2,7,9,25,0.000014
PeopleOfWalmart,,,4,16,20,1,0.000017
House Kheperu,,,7,16,23,27,0.000015
Consort,,,1,0,1,27,0.000011
Pink Spider,,,4,59,63,27,0.000014
Housemdfan,,,0,4,4,41,0.000011
Photobomb,,,2,19,21,9,0.000011
Modern Warfare,,,5,0,5,37,0.000015
MystressOfDarkness13,,,5,71,76,21,0.000014
WikiAnswers,,,4,14,18,2,0.000017
How to make money online,,,1,3,4,41,0.000011
Scandal,,,7,7,14,19,0.000022
Hrafnagardh,,,1,13,14,40,0.000012
Huffington Post,,,4,3,7,19,0.000012
Lee Westwick,,,4,41,45,44,0.000016
Sdf,,,2,0,2,7,0.000023
Kelly Hallissey,,,5,30,35,10,0.000025
Internet boyfriend,,,1,0,1,12,0.000011
Mwells,,,3,10,13,8,0.000018
Weiner,,,4,3,7,14,0.000014
Hughstan Schlicker,,,0,22,22,13,0.000011
The Fidel Castro El Zol Prank,,,3,42,45,14,0.000011
Human Trafficking,,,3,16,19,35,0.000019
Humour,,,1,1,2,44,0.000011
Turulchan,,,3,44,47,9,0.000013
Scotty24360,,,2,30,32,53,0.000011
HunterHewett,,,1,26,27,7,0.000011
Jcterminal,,,5,49,54,8,0.000012
Theology,,,3,31,34,46,0.000032
Hussein Khavari,,,0,34,34,37,0.000011
Hydrozoa,,,2,8,10,8,0.000012
Hyldenism,,,2,7,9,46,0.000019
Hyper2faceman,,,0,8,8,21,0.000011
Hyper Forums,,,0,93,93,8,0.000011
Hideous,,,1,0,1,32,0.000011
Hypercube Aftermath,,,2,23,25,64,0.000011
Hypercube Quotes 1,,,1,0,1,64,0.000011
Hypercube Quotes 2,,,1,0,1,64,0.000011
Hypnox,,,2,10,12,8,0.000021
Hyskoa,,,5,55,60,57,0.000011
Hyuugalanna,,,1,9,10,21,0.000012
Televangelist,,,1,0,1,35,0.000012
I'M X,,,3,51,54,10,0.000015
I'm A Prefect,,,0,8,8,37,0.000011
TL;DR/Gatsby,,,1,1,2,8,0.000016
Random-ness Wiki,,,4,47,51,6,0.000055
I-Dosing,,,0,11,11,60,0.000011
I-Mockery,,,2,6,8,6,0.000011
Newgrounds/BBS,,,2,27,29,6,0.000012
I-heart-hikaru/notes,,,1,1,2,21,0.000011
Teenchatcenter.com,,,4,27,31,38,0.000015
Marcus the hedgehog,,,6,13,19,21,0.000013
COCKS COCKS COCKS I SUCK HUNDREDS OF COCKS,,,4,0,4,24,0.000011
ICVD/JorgeCraziness,,,1,0,1,24,0.000011
The Dolmen,,,2,26,28,27,0.000012
IChan (chan),,,1,9,10,9,0.000011
Schaun Bishop,,,2,3,5,7,0.000012
Tana Mongeau,,,3,6,9,48,0.000013
IGNEELTHEGREAT,,,0,8,8,15,0.000011
MySpace Whores,,,3,23,26,12,0.000013
The Dark Knight IMDb Board,,,3,33,36,15,0.000013
The IMDb Politics Board,,,4,36,40,14,0.000011
Steve Lake,,,5,10,15,41,0.000012
IMG!/logs,,,1,1,2,64,0.000011
Lalalalasers,,,1,11,12,9,0.000016
IMVU/logs,,,1,4,5,12,0.000011
IM GOING TO MAKE NATIONAL NEWS,,,3,23,26,11,0.000011
INTJ,,,1,29,30,12,0.000011
Double standards,,,1,0,1,12,0.000011
Tailing logs,,,1,5,6,10,0.000011
IPhone 6 features,,,2,7,9,10,0.000011
Waterproof iOS7,,,2,14,16,10,0.000012
MIRC Script,,,2,11,13,10,0.00003
"Äm-irk",,,1,18,19,41,0.000011
SavIRC,,,1,0,1,10,0.000011
JIRC,,,1,0,1,10,0.000011
DIRC,,,1,0,1,10,0.000011
PIRCh,,,1,0,1,10,0.000011
IrcII,,,1,0,1,10,0.000011
Naim,,,1,0,1,10,0.000011
Ircabi,,,1,0,1,10,0.000011
Jpirc,,,1,0,1,10,0.000011
JmIrc,,,1,0,1,10,0.000011
Irssi/scripts,,,4,6,10,10,0.000015
IRC Disease,,,1,11,12,8,0.000021
Idle,,,3,13,16,41,0.000012
Idlenet,,,6,16,22,41,0.000027
Switch,,,1,2,3,41,0.000011
Irc.kottnet.net,,,1,0,1,41,0.000011
Important people,,,1,14,15,3,0.000068
The 1% Doctrine,,,4,21,25,41,0.000014
IRT,,,2,50,52,1,0.000011
ISketch,,,3,14,17,64,0.000012
Quicktime,,,4,18,22,10,0.000013
ITunes Store,,,2,36,38,10,0.000011
Jasmine Richardson,,,4,29,33,12,0.000018
LOLcat Translator Project,,,5,11,16,25,0.000015
Scorehero,,,2,42,44,54,0.000015
Steamloller,,,17,11,28,48,0.000147
LOL PENIS,,,1,24,25,36,0.000011
I WOULD HAVE SEX WITH ALL THIS WHITE GIRLS,,,2,3,5,35,0.000011
I Wanna Be The Guy,,,1,33,34,49,0.000011
Shorter,,,3,4,7,14,0.000018
I cri evrytiem,,,1,3,4,9,0.000011
Patrick Knight,,,6,8,14,41,0.000022
Wii Fit,,,8,33,41,52,0.000033
Shentao Muise,,,5,91,96,19,0.000018
I heard it on the Internet,,,1,21,22,5,0.000033
Offensive T-Shirts,,,2,41,43,35,0.000015
I need a price check ...,,,5,36,41,9,0.000011
I resurrected this pearl from page 10,,,4,10,14,9,0.000011
Ray Dixon,,,4,7,11,59,0.000013
Iain Hall/Deviant Behaviour,,,1,11,12,59,0.000012
"The ""Black Wednesday"" Saga",,,1,1,2,59,0.000012
Iain Hall/Email Transcripts,,,2,3,5,59,0.000012
PFFA,,,3,7,10,8,0.000014
Ian (disambiguation),,,1,12,13,19,0.000013
Ian Hasselhoff,,,3,49,52,57,0.000012
It's a Fake,,,4,6,10,9,0.000017
StrangerWithCandy,,,3,32,35,28,0.000011
Icarus,,,0,8,8,49,0.000011
Ishkur,,,4,12,16,12,0.000013
Ice Poseidon,,,2,15,17,35,0.000012
Icechat,,,0,21,21,41,0.000011
Icedancer 4,,,1,43,44,62,0.000011
Iceslave,,,5,34,39,37,0.000012
Ickeriss69/kidnapped,,,1,2,3,7,0.000011
Panic,,,1,0,1,4,0.000011
Manliness,,,1,0,1,4,0.000011
Unstable,,,1,0,1,4,0.000011
Cockslap,,,1,0,1,4,0.000011
Identity theft/Stem,,,1,0,1,3,0.000013
Is chat working?,,,2,2,4,41,0.000012
Ilana Angel,,,0,22,22,36,0.000011
Fatter,,,1,0,1,36,0.000011
Ilbe Storehouse,,,0,1,1,28,0.000011
Ilija Grahovac,,,2,8,10,5,0.000014
Illemonati,,,3,26,29,8,0.000019
KingEmpoleon,,,5,42,47,7,0.000015
Illlaw,,,2,11,13,8,0.000013
Illuminati Confirmed,,,1,6,7,17,0.000014
Illusion,,,2,2,4,4,0.000012
Steve,,,1,39,40,43,0.000015
That LJ thing that Adcott wrote that displays the last 50 images posted,,,3,2,5,9,0.000015
Spaceghetto,,,3,8,11,9,0.000028
Lisa Ventura,,,5,17,22,18,0.000015
Klutzypriss07,,,3,25,28,8,0.000012
Moid,,,2,21,23,38,0.000012
Tripod,,,1,18,19,10,0.000012
Org Infinity,,,7,70,77,6,0.000013
Imanihilist,,,1,1,2,8,0.000013
Marxist thug,,,5,12,17,8,0.000017
Imeem,,,4,55,59,12,0.000017
Imgsrc.ru,,,1,7,8,22,0.000011
Nikkineko333,,,12,60,72,7,0.000015
Haihaikittyppg,,,2,0,2,7,0.000011
Nuke edition,,,1,0,1,9,0.000011
USASexGuide Forum,,,5,20,25,36,0.000014
ImposterBuster,,,1,64,65,19,0.000011
InSaNe-REYNARD/convologs,,,1,8,9,41,0.000011
In Utero,,,6,45,51,12,0.000018
In popular culture,,,6,17,23,2,0.000027
Prototype,,,5,119,124,49,0.000013
SlutHate,,,3,3,6,58,0.000012
Inception Cat,,,4,6,10,34,0.000012
Incest/Brother,,,1,1,2,42,0.000034
Incest/Step Sister,,,1,2,3,42,0.000034
Incest/Mother,,,1,1,2,42,0.000034
Wasd,,,2,7,9,37,0.000034
Incestlogs:001,,,0,3,3,41,0.000011
Incestlogs:002,,,0,3,3,41,0.000011
Incomplete Guy,,,2,22,24,9,0.000015
Incontinence,,,4,28,32,22,0.000011
Lackadaisy,,,1,15,16,28,0.000034
Walruse,,,5,16,21,9,0.000014
Ricki Raven,,,2,35,37,12,0.000014
ScriptLance,,,2,20,22,10,0.000013
New Romantic,,,3,7,10,12,0.000013
Tools,,,1,0,1,8,0.000012
Takumi,,,1,0,1,8,0.000012
Permanent suspension,,,1,0,1,8,0.000012
Inesthelostangel,,,1,8,9,7,0.000011
The AR Archive,,,4,12,16,53,0.000037
PunkyHusky,,,3,45,48,32,0.000013
Inflatablewolfi/Logs,,,1,1,2,31,0.000011
Megarob15,,,2,23,25,7,0.000012
Shineofrain,,,3,28,31,19,0.000012
Pretendians,,,3,35,38,35,0.000022
New User Registration,,,3,27,30,2,0.000015
Inkpop,,,2,27,29,40,0.000011
Prime radiant,,,8,18,26,8,0.000031
Ted-Drakness,,,7,63,70,21,0.000025
XXAshBiohazardXx,,,1,26,27,21,0.00002
Theresa Sheller,,,6,29,35,48,0.000021
Robert Byrd,,,12,17,29,35,0.000028
Juggalo Holocaust,,,5,61,66,51,0.000016
RonBudda6699,,,6,41,47,48,0.000014
Insane Clown Posse/SerialKillaC,,,2,1,3,51,0.000013
Insane Clown Posse/TL;DR,,,1,4,5,51,0.000013
Porn Clown,,,7,1,8,51,0.000015
TwiztidAsh,,,4,44,48,51,0.000014
Insane Clown Posse/IRC Fail,,,2,1,3,51,0.000012
Unicorn,,,4,6,10,51,0.000012
Insanealterness,,,0,13,13,15,0.000011
Insectduel,,,2,9,11,10,0.000011
SNSD,,,4,34,38,36,0.000011
Integer,,,0,10,10,46,0.000011
IntelMiner,,,3,134,137,10,0.000012
Intelligent Dance Music,,,1,30,31,12,0.000012
Ingeniously clever,,,1,0,1,9,0.000012
Internal Applause,,,3,4,7,39,0.000013
Secret policy document,,,4,9,13,8,0.000055
Oschaper,,,7,48,55,26,0.000017
Mehungwaylo,,,4,54,58,41,0.000012
Internet Freedom Movement/Arbchat,,,1,1,2,10,0.000012
Michelle Bombshell,,,7,6,13,56,0.000016
Lorac Black,,,2,26,28,31,0.000012
Trisha Paytas,,,2,13,15,8,0.000012
Zoom angel,,,2,13,15,36,0.000011
TPMMuckraker Mole,,,9,22,31,14,0.000012
Izzi (Sileas),,,4,53,57,37,0.000021
Internet Rehab,,,1,8,9,36,0.000012
Todd in the Shadows,,,10,30,40,19,0.000021
Psfights,,,2,10,12,35,0.000017
Internet blood sports,,,0,57,57,19,0.000011
Jean-Francois Gariepy,,,3,24,27,19,0.000012
Israblog,,,2,48,50,12,0.000018
Internet newscast,,,1,10,11,48,0.000011
Poor skills,,,4,15,19,8,0.000015
Yellowsnakepoet,,,5,21,26,8,0.000016
World Wide Web Consortium,,,5,49,54,10,0.000038
Internrt,,,1,9,10,50,0.000033
Introduction to English,,,4,16,20,41,0.000012
Interrobang,,,2,13,15,9,0.000011
Twitch Plays Pokemon,,,3,50,53,41,0.000013
Xbox Republic,,,3,50,53,49,0.000011
Inuboy1000/Chatlogs,,,1,0,1,7,0.000011
Inuki,,,3,37,40,31,0.000012
Metal (furry),,,3,45,48,28,0.000023
Invisible Girlfriend,,,2,24,26,7,0.000011
Pigchan,,,5,25,30,9,0.000015
Ips666,,,0,18,18,7,0.000011
Megan Had It Coming,,,8,31,39,41,0.000013
IrcImages,,,2,23,25,37,0.000011
Camel humpers,,,1,0,1,37,0.000013
Tank,,,1,0,1,37,0.000013
Bollix,,,1,0,1,37,0.000013
Patrick,,,5,10,15,37,0.000021
Irene Drincic,,,0,11,11,7,0.000011
Iris,,,2,30,32,8,0.000011
Nyoko,,,2,47,49,8,0.000011
PLEASE RESPOND,,,8,4,12,38,0.000028
TaskForce,,,3,9,12,12,0.000015
Irssi/scripts/blocks.pl,,,2,0,2,41,0.000013
At least 100 times,,,1,0,1,49,0.000013
Merle Whitefire,,,3,65,68,24,0.000014
Is Your Son a Computer Hacker?/Original,,,1,50,51,10,0.000011
Shi'ites,,,1,10,11,37,0.000015
Muslim Dating Sites,,,6,12,18,37,0.000017
Jake Bilardi,,,3,12,15,37,0.000014
Ismail Ax Lyrics,,,1,7,8,58,0.000011
It's/Its,,,1,4,5,3,0.000022
Tomoko Kuroki NTR,,,3,7,10,28,0.000012
Kirbyfan1234,,,3,11,14,49,0.000012
The Casey,,,7,46,53,6,0.000012
Itachikunlover,,,1,49,50,19,0.000011
ItalianGuyFromNY,,,1,44,45,48,0.000012
Apes,,,1,0,1,37,0.000014
ItsAboutJesus,,,6,32,38,46,0.000013
Itssaphiragore,,,4,65,69,48,0.000011
Iyami-ame,,,1,37,38,21,0.000011
Sarah Butts/ffshrine chatlogs,,,3,8,11,19,0.000012
Unseenperfidy,,,2,12,14,46,0.000012
James Woods,,,2,19,21,19,0.000011
J. Neil Jednoralski,,,0,40,40,14,0.000011
RAWR,,,2,34,36,4,0.000016
Jews did WTC Documentary,,,2,4,6,17,0.000024
Realism911,,,1,11,12,41,0.000024
Slave Tetris,,,4,9,13,19,0.000025
JG Bennett,,,2,13,15,1,0.000011
Xalainu,,,3,17,20,50,0.000011
JS,,,0,36,36,6,0.000011
Jana Shearer,,,3,28,31,35,0.000015
Jennifer Strange,,,4,3,7,49,0.000013
Joe Somebody,,,5,30,35,48,0.000012
Jorge Serrano,,,2,9,11,40,0.00002
Xiaolin Showdown,,,4,77,81,28,0.000013
Just Saying,,,1,9,10,57,0.000011
Jack Phoenix,,,4,45,49,2,0.000012
Octopus Girl,,,8,6,14,28,0.000021
Tyler Redick,,,3,35,38,61,0.000013
Jack Valenti,,,3,14,17,53,0.000016
The Rock Driving,,,11,45,56,9,0.000071
Jackson Jawbreaker,,,2,58,60,25,0.000012
TheAmazingAtheist/NotProductive,,,2,9,11,49,0.000012
Jacob,,,0,3,3,26,0.000011
Musical.ly,,,4,10,14,17,0.000013
Jacobse & van Es,,,0,14,14,19,0.000011
The Register,,,2,18,20,10,0.000011
Jact,,,3,16,19,49,0.000074
Planking,,,6,12,18,58,0.000016
User:Playerx85/Funorb,,,1,0,1,49,0.000012
Jailhouse burrito,,,3,20,23,39,0.00002
Jak and Daxter,,,1,20,21,49,0.000011
Jake,,,0,9,9,2,0.000011
The Trashman,,,7,32,39,41,0.000013
ROFLCon,,,4,19,23,9,0.000017
James,,,0,21,21,46,0.000011
James Fagan,,,3,30,33,14,0.000014
James L. Grant,,,2,27,29,24,0.000012
James S. Harris,,,5,32,37,6,0.000044
James Jay Lee,,,1,16,17,46,0.000011
James Packer,,,4,16,20,26,0.000013
James the Preacher,,,2,16,18,46,0.000011
James Watson,,,6,28,34,35,0.000025
Laura Loomer,,,5,26,31,19,0.000034
James Emails 1,,,4,1,5,7,0.000041
James Terry Mitchell Jr,,,6,8,14,7,0.00008
James Emails 2,,,3,3,6,7,0.000032
James Emails 3,,,3,4,7,7,0.000034
James Emails 4,,,2,4,6,7,0.000026
Long-winded people,,,4,20,24,41,0.000015
Montel Williams,,,4,17,21,46,0.000014
Porsche,,,4,5,9,8,0.000025
Jamich,,,2,10,12,34,0.000011
Jamie,,,0,3,3,41,0.000011
Jamnoise72,,,0,4,4,30,0.000011
Jan Huokko,,,3,18,21,40,0.000013
Jan Maturbongs,,,3,7,10,26,0.000016
Jan Terri,,,3,27,30,22,0.000014
Jananaphone,,,1,16,17,36,0.000018
Pokémon/rule34,,,2,39,41,21,0.000014
Jared,,,1,13,14,19,0.000011
Jared Aycock,,,0,1,1,61,0.000011
Ken Friedel,,,2,8,10,7,0.000012
Judge David-Wynn Miller,,,4,21,25,58,0.000012
SnackyCakes2008,,,6,120,126,15,0.000018
Jason,,,1,21,22,0,0.000011
Jason Begin,,,2,1,3,22,0.000012
Robert Casio,,,4,24,28,22,0.000022
Jason Blaha,,,0,9,9,48,0.000011
Truth-Lely-Gaia,,,3,43,46,7,0.000012
Jasper,,,4,54,58,30,0.000015
Rename tokens,,,1,5,6,8,0.000011
Blue balls,,,1,0,1,30,0.000011
Jay Bundy,,,3,15,18,35,0.000026
Jay Herrod,,,1,16,17,48,0.000019
Jay Wakefield,,,1,28,29,61,0.000011
JayisCrazay,,,0,15,15,34,0.000011
Jaymz Mutz,,,6,70,76,31,0.000011
Klerck,,,5,14,19,41,0.000022
Rahaeli,,,3,7,10,8,0.000011
Jdsonic,,,3,15,18,51,0.00003
Jed,,,2,14,16,9,0.000011
Jed Whitaker,,,1,9,10,19,0.000011
Very proud to be an asian,,,6,72,78,28,0.000012
Jeff,,,3,2,5,9,0.000011
Jeff Corwin,,,1,16,17,31,0.000012
Jeff Weise/Reactions,,,1,1,2,58,0.000011
Jeff Weise/Flash,,,1,2,3,58,0.000011
Jeff Weise/Surviving The Dead,,,1,1,2,58,0.000011
Jeff Weise/FOIA,,,1,1,2,17,0.000011
Newgrounds/BBS/Members,,,2,138,140,4,0.000011
The Glamorous Life of Sachiko Hanai,,,2,9,11,14,0.000012
Jeffree Moon,,,2,65,67,32,0.000011
Kewl,,,1,0,1,12,0.000011
Thebalrog6,,,1,33,34,7,0.000011
Jellobuns,,,3,21,24,21,0.000011
Encyclopedia Dramatica:Thizzlehat Junction Center,,,2,0,2,15,0.000013
The Daytona Nine,,,5,19,24,40,0.000014
Jeni Ann/yahoo,,,1,0,1,36,0.000011
Jeni Ann/chatlog,,,1,0,1,36,0.000011
Jenna Rose,,,1,39,40,16,0.000011
Jennet Wolfskunk,,,3,8,11,8,0.000014
Jennichelle,,,6,12,18,41,0.000014
Jennifer,,,0,20,20,36,0.000011
Jennifer Doran,,,3,8,11,36,0.000011
Jennifer Livingston,,,1,12,13,52,0.000011
Jennifer Lynn Petkov,,,5,14,19,41,0.000011
Jenny Jones,,,2,37,39,33,0.000013
Trojanbaby,,,3,6,9,39,0.000014
Nonfluffypagans,,,4,10,14,8,0.000012
Magoogate,,,5,41,46,26,0.000011
Laughing Witch,,,2,3,5,46,0.000013
Jeremiah True,,,5,27,32,39,0.000016
Nolongersilenced,,,3,7,10,19,0.000011
The Russian LJ Abuse Conspiracy,,,6,21,27,8,0.000015
Jeremy Hambly,,,0,138,138,19,0.000011
Tucker Carlson,,,3,13,16,19,0.000012
Encyclopedia Dramatica:Style Guide,,,2,0,2,26,0.000012
Younger Woolwich Boyz,,,6,42,48,35,0.000012
Jerry,,,1,19,20,35,0.000012
Tom and Jerry,,,7,20,27,37,0.000016
My body is ready,,,1,0,1,57,0.000011
Jesse H,,,0,1,1,37,0.000011
Please reply,,,1,0,1,12,0.000012
Jessi Slaughter/Timeline,,,1,44,45,12,0.000012
MissSunkistCarmen,,,3,27,30,53,0.000012
Sext,,,1,0,1,12,0.000011
Jessica,,,0,9,9,41,0.000011
Zerodomon,,,3,26,29,23,0.000012
Melody Hensley,,,3,53,56,19,0.000011
Joseph,,,1,13,14,37,0.000017
Encyclopediadramatica.rs,,,2,0,2,37,0.000017
Jesus Chatline,,,1,9,10,41,0.000013
Michael Bloomberg,,,3,40,43,14,0.000016
isla‎m,,,1,0,1,37,0.000017
Jews/Gallery,,,2,11,13,37,0.000024
Jews/Who is a Jew?,,,0,149,149,17,0.000011
Sergey Brin,,,6,48,54,10,0.000031
Vermin Supreme,,,6,28,34,14,0.000014
Shakakuskeeper,,,3,5,8,21,0.000019
JiZZy: Pakistan,,,0,7,7,37,0.000011
Jigglypuff,,,1,4,5,19,0.000012
Smugglypuff,,,7,37,44,19,0.00002
Jihad Jane,,,2,10,12,37,0.000013
Jilly Juice,,,0,1,1,36,0.000011
Jim Groat,,,2,12,14,31,0.000011
Jim Rome,,,4,15,19,34,0.000014
Jim Jordan,,,5,14,19,35,0.000027
Plethora,,,1,5,6,8,0.000013
Jimbo Wales/Chat logs,,,2,5,7,2,0.000014
Employee,,,1,0,1,2,0.000013
Jiminycricketfan007/tl;dr,,,1,1,2,53,0.000011
Jimmy Savile/Byford Report,,,0,1,1,14,0.000011
Jin,,,0,4,4,15,0.000011
Joan Cornellá,,,1,30,31,13,0.000012
Joby Dimms,,,0,11,11,7,0.000011
Joclings,,,1,34,35,10,0.000011
Jodie Hudson,,,1,13,14,36,0.000011
Joe Exotic,,,0,32,32,50,0.000011
Achievement,,,1,0,1,50,0.000011
Joe Firmage,,,0,3,3,17,0.000011
Joe Leger,,,0,17,17,12,0.000011
Morning Glory,,,2,12,14,39,0.000011
Joedaddy505,,,1,13,14,1,0.000011
Justin.tv,,,11,60,71,11,0.000024
Twitch Raids,,,3,16,19,26,0.000012
Joeker,,,0,36,36,24,0.000011
Joel Hawkins,,,0,8,8,9,0.000011
Joel Monaghan,,,0,30,30,31,0.000011
Rugby league,,,1,0,1,31,0.000011
Joel Osteen,,,0,26,26,19,0.000011
Johanna Herrstedt,,,0,5,5,9,0.000011
John Assanti,,,1,17,18,52,0.000011
John Best Junior,,,4,53,57,24,0.000011
John Forehand,,,1,19,20,3,0.000011
John Walker Lindh,,,5,34,39,37,0.000019
Shaye Saint John,,,4,13,17,63,0.000017
John69,,,1,8,9,26,0.000011
Vanity Page,,,5,37,42,48,0.000042
John Campbell/I'VE BEEN PRETENDING TO BE DEPRESSED FOR PROFIT AND I'M SORRY,,,1,0,1,19,0.000011
John Campbell/I'VE BEEN PRETENDING TO BE PRETENDING TO HAVE DEPRESSION FOR PROFIT,,,1,0,1,19,0.000011
John Campbell/IT IS IMPOSSIBLE TO PRETEND TO DO OR SAY ANYTHING,,,1,0,1,19,0.000011
John Carmichael,,,3,16,19,26,0.000014
WrestleCrap,,,3,34,37,15,0.000012
Ogg,,,3,8,11,10,0.000013
Explosion,,,1,0,1,15,0.000011
John Field/Logs,,,0,1,1,51,0.000011
Netizens,,,1,0,1,3,0.000011
John J. Pershing,,,1,5,6,37,0.000014
SarahChihuahua,,,3,25,28,21,0.000011
Loco Melones,,,3,27,30,34,0.000024
ToonEGuy,,,5,54,59,34,0.000014
John Leigh,,,0,3,3,28,0.000011
John Patrick Rogers,,,0,75,75,30,0.000011
John Terry,,,7,16,23,9,0.000014
Johnathan Franklin Lerner,,,0,40,40,7,0.000011
Johni Michelle Heuser,,,1,16,17,27,0.000011
Saya no Uta,,,5,29,34,28,0.000013
Wage Gap,,,4,17,21,19,0.000012
JonahsVore,,,3,15,18,21,0.000015
Jonathan,,,0,10,10,43,0.000011
Jonathan Mitchell,,,1,2,3,7,0.000012
Jonathan Lee Riches,,,4,27,31,14,0.000015
Jonathan Swift,,,2,28,30,37,0.000014
Jones,,,1,5,6,33,0.000012
Marion Jones,,,1,34,35,49,0.000013
Jonifications,,,0,3,3,7,0.000011
Jordan,,,5,6,11,37,0.000021
Tommy Jordan,,,3,18,21,48,0.000014
Jordan Peterson,,,2,2,4,19,0.000016
Jose Rafael Cordero Sanchez,,,0,1,1,9,0.000011
Josef,,,0,7,7,9,0.000011
Josef Heiter,,,3,2,5,9,0.000013
Operation Merry Fritzmas,,,1,4,5,39,0.000013
Joseph Martelli,,,2,35,37,32,0.000012
Overly Attached Girlfriend,,,2,2,4,59,0.000012
Lukeywes1234,,,5,54,59,9,0.000075
Josh Macedo,,,4,29,33,53,0.000016
Moveable Type,,,4,8,12,8,0.000035
SocialJournal,,,2,2,4,8,0.000017
Joutchkov,,,1,26,27,0,0.000011
Jovana Rikalo,,,2,21,23,19,0.000011
Joy Reid,,,0,23,23,19,0.000011
Jp22,,,2,8,10,3,0.000011
Juan Luis Lagunas Rosales,,,0,12,12,56,0.000011
Judas YouTube blacklist,,,1,28,29,48,0.000014
SirFlibble,,,3,16,19,48,0.000012
Nohogirls,,,1,0,1,48,0.000011
Wehogirls,,,1,0,1,48,0.000011
Jude's Army/Chat with The Dude,,,1,1,2,41,0.000011
Judge Rotenberg Center,,,0,18,18,7,0.000011
Rusty Ray,,,4,44,48,33,0.000013
Judgespear,,,1,3,4,50,0.000011
Judith Park,,,3,45,48,41,0.000011
Lolo Ferrari,,,8,39,47,36,0.000038
JuggaletteJenny/arbchat,,,2,3,5,47,0.000011
XrissXrow,,,6,35,41,52,0.000013
Twizidwickedlette,,,2,45,47,51,0.000012
Juice,,,0,5,5,35,0.000011
Julesoogle,,,0,27,27,40,0.000011
Marry Your Favorite Character Online,,,7,43,50,38,0.000018
Julie Terryberry,,,0,12,12,7,0.000011
Jumpman,,,2,16,18,40,0.000011
Just Be a Fucking Feminist You Shitbags,,,1,44,45,39,0.000011
Justin,,,0,9,9,19,0.000011
Sarahisnifty,,,2,14,16,7,0.000011
Mariah Yeater,,,1,17,18,53,0.000012
Justin Dabrow,,,2,23,25,34,0.000011
Justin Futrell,,,1,14,15,9,0.000012
Main Page/ED:BNA,,,3,4,7,19,0.000016
Justine Jacobs,,,2,30,32,46,0.000011
Jwolfsky,,,2,51,53,31,0.000011
Was fired,,,1,0,1,31,0.000011
JxcelDolghmQ,,,3,9,12,9,0.000011
TOV,,,3,2,5,2,0.000011
K,,,0,16,16,21,0.000011
File:Roundworms-th.jpg,,,2,0,2,17,0.000011
K-hate,,,2,13,15,63,0.000013
Lesleyblood,,,6,67,73,48,0.000011
Th3Royism,,,4,55,59,48,0.000011
K9X,,,0,11,11,34,0.000011
KK,,,1,10,11,53,0.000014
KaBlamBandicoot64,,,6,19,25,34,0.000014
Kabolic,,,0,5,5,3,0.000011
Kabutolover334,,,2,36,38,7,0.000011
Kai the Hitchhiker,,,2,16,18,41,0.000011
Kail,,,5,27,32,12,0.000016
Kaitlin Jackson,,,0,11,11,41,0.000011
User:Drunkenlazybastard,,,2,0,2,52,0.000012
Kamal Saleh,,,0,7,7,48,0.000011
Kamau Kambon,,,0,1,1,35,0.000011
Kamelopedia,,,1,6,7,37,0.000011
Kami Boh,,,1,15,16,36,0.000011
Kamptonleader,,,0,9,9,31,0.000011
Kamunou Hyena,,,3,24,27,31,0.000013
Sam Pepper,,,5,10,15,19,0.000012
Kangaroo Jack,,,3,12,15,21,0.000015
Twatter/KanyeWest,,,1,2,3,5,0.000027
Warden-warden,,,2,2,4,21,0.000011
Karamatsugirllover92,,,2,20,22,7,0.000011
Ruben Guzman,,,2,23,25,7,0.000011
Dawg,,,1,0,1,29,0.000012
Karel++,,,0,13,13,10,0.000011
Karinbyrne,,,0,1,1,19,0.000011
Wikitheft,,,1,17,18,2,0.000011
Kasai,,,3,13,16,8,0.000012
Kassi Kandi,,,0,50,50,19,0.000011
Bullemic,,,1,0,1,19,0.000011
Kat15lee,,,1,7,8,8,0.000011
Lolfurries,,,6,17,23,31,0.000013
Kathleen Todd,,,9,86,95,49,0.000015
Bossy,,,1,0,1,49,0.000011
Going commando,,,1,0,1,36,0.000011
Katie Hopkins,,,3,6,9,37,0.000015
Nyan~ Neko Sugar Girls,,,2,14,16,28,0.000015
Pikichu,,,1,0,1,36,0.000011
KawaiiNekoGirl/Chat logs,,,1,2,3,5,0.000011
The Tails Realm,,,3,43,46,1,0.000011
Kay Fedewa/Arbchat,,,1,1,2,24,0.000011
Kazantzakis/Dan quits IRC forever,,,1,0,1,52,0.000012
Keaton Jones,,,0,4,4,19,0.000011
Keely Villar,,,1,27,28,59,0.000011
The Nightmare Before Christmas,,,7,67,74,12,0.000012
Keep your email private,,,0,11,11,0,0.000011
Keeshaun,,,3,13,16,41,0.000011
Keith,,,0,5,5,10,0.000011
NotMySuperbowlChamps,,,5,16,21,19,0.000016
Kelly,,,0,5,5,36,0.000011
TheAmazingAtheist/Friends,,,2,13,15,14,0.000012
Kelly Martin/somnambulation-i-am-exceptionally,,,1,1,2,5,0.000011
Kelly Martin/Wikitruth,,,1,4,5,27,0.000011
Quora,,,1,23,24,38,0.000011
Kelly Martin Broderick,,,3,10,13,52,0.000011
Kelpie Dingo,,,2,4,6,31,0.000034
Kelsey Marie Mercer,,,0,1,1,28,0.000011
Otakin,,,5,4,9,8,0.000012
Shills,,,1,0,1,26,0.000012
Sema JayHawk,,,8,43,51,31,0.000021
Kenker,,,2,2,4,41,0.000012
Wayne Chiang,,,3,21,24,11,0.00002
Kenneth Englehardt,,,1,9,10,7,0.000011
Tyler Weinman,,,2,33,35,25,0.000012
Solar System,,,5,42,47,46,0.000015
Kerry Keane,,,0,33,33,39,0.000011
Nicole Ritchie,,,10,26,36,36,0.000019
Personal truth,,,2,7,9,39,0.000011
Kesha/Lawsuit,,,2,291,293,19,0.000012
Maggie Lindemann,,,1,33,34,19,0.000011
WikiHow,,,4,25,29,2,0.000013
Kesha/Celebrities,,,2,105,107,15,0.000012
There are starving children in china,,,6,13,19,9,0.000011
Mara,,,1,39,40,63,0.000011
Kesha/Gallery,,,1,88,89,39,0.000012
Kesha/Infobox,,,0,23,23,35,0.000011
Nigger Kike Jew Jar,,,2,5,7,19,0.000011
Raped Statistics,,,4,13,17,19,0.000012
Kesha/Nav,,,0,8,8,36,0.000011
Kesha/Related Drama,,,1,87,88,36,0.000012
Kesha/Timeline,,,1,100,101,36,0.000012
Kesha/White Knights,,,1,89,90,19,0.000012
Kesha/Quotes,,,1,25,26,19,0.000012
Terrible,,,1,0,1,36,0.000011
Creepshots,,,1,0,1,36,0.000011
Kevin,,,1,22,23,36,0.000014
StefanUrquelle1994,,,1,13,14,46,0.000011
Kevin L. O'Brien,,,1,13,14,41,0.000011
Kevin Underwood,,,2,7,9,3,0.000015
Romaji,,,3,27,30,28,0.000011
Futility,,,2,0,2,26,0.000011
Kevin Havens/Kevin's Dolls,,,1,77,78,50,0.000011
Kevin Havens/The Smokerchip Document,,,1,0,1,50,0.000011
Kevin Mann,,,2,48,50,48,0.000012
Kewian/Reaction Log,,,1,1,2,39,0.000013
Kewian/Arbchat log,,,1,1,2,39,0.000013
Keyboard Whore,,,4,27,31,9,0.000015
Typewriter,,,1,47,48,10,0.000012
Keycorp,,,2,8,10,17,0.000011
Keylogging,,,5,3,8,41,0.000013
Kgb,,,0,43,43,10,0.000011
Muenster Truck Attack 2018,,,3,9,12,37,0.000014
Kharisma Jati,,,0,32,32,22,0.000011
Uziga Waita,,,1,18,19,22,0.000011
Taryn,,,2,34,36,40,0.000011
Kicesie,,,3,74,77,48,0.000011
Kid Icarus,,,1,26,27,49,0.000011
Kidavi,,,1,27,28,36,0.000011
Kigichi,,,0,9,9,28,0.000011
Killzone 2,,,2,96,98,49,0.000011
Kilroy Event,,,1,10,11,19,0.000014
LoneWolf1984,,,4,2,6,21,0.000013
Kimberleigh Ann Keister,,,2,42,44,31,0.000011
Animator,,,1,0,1,31,0.000011
Trainwreck,,,1,0,1,31,0.000011
Kimilsung,,,2,56,58,31,0.000011
Venator-Somniorum,,,2,78,80,31,0.000011
Superdickery,,,6,19,25,34,0.000014
Vajna,,,3,15,18,2,0.000013
Kimmsanity,,,2,108,110,13,0.000011
True facts,,,1,0,1,13,0.000011
KindredSpirits,,,3,8,11,39,0.000028
Toukan,,,1,0,1,21,0.000011
King.com,,,4,5,9,10,0.000013
Pasta,,,2,3,5,22,0.00002
King of the Weeaboos,,,2,19,21,28,0.000019
Yaoi-ultima,,,2,12,14,21,0.000011
Kingdom of Loathing,,,8,69,77,52,0.000017
What does he have against furries?,,,1,0,1,52,0.000011
Kinmotsu7,,,2,34,36,31,0.000011
School Bus Fight,,,4,15,19,12,0.000012
Kirbyslover/archive 1,,,2,6,8,38,0.000011
Kitsep,,,2,13,15,32,0.000011
Kitty006,,,1,28,29,21,0.000011
KittyKaiti,,,1,33,34,28,0.000015
Kitty Krew,,,3,18,21,4,0.000011
Wrong Planet,,,2,20,22,7,0.000012
Kiznaiver,,,2,12,14,28,0.000011
Space Patrol Luluco,,,2,16,18,28,0.000012
Stoofoo,,,1,0,1,41,0.000012
Kligzward,,,1,5,6,33,0.000011
Klitschko brothers,,,1,15,16,37,0.000011
Klout,,,2,8,10,59,0.000011
Knitted willy warmer,,,3,4,7,39,0.00002
Pachirisu,,,2,15,17,26,0.000012
Koda,,,3,20,23,36,0.000011
TV Tropes/KodomoNoJikan,,,2,2,4,1,0.000011
Kohlchan,,,2,15,17,37,0.000012
Kolkhoznik,,,1,11,12,21,0.000011
Kombucha,,,0,1,1,35,0.000011
Tripfag Orgy,,,1,6,7,9,0.000011
Kongzillarex619,,,0,30,30,28,0.000011
Kono Reizei,,,0,3,3,49,0.000011
KoolDrawer,,,3,41,44,24,0.000011
Koolkakashi123,,,0,14,14,0,0.000011
Korax,,,6,17,23,9,0.000012
Buttraep,,,1,0,1,9,0.000011
Sharknado,,,1,0,1,49,0.000015
Koryoko,,,0,11,11,61,0.000011
New Media Rockstars,,,3,27,30,12,0.000013
Krensada,,,1,46,47,46,0.000011
Kripparrian,,,2,2,4,18,0.000011
Krispup,,,1,4,5,31,0.000011
Kristi Lovett,,,0,10,10,48,0.000011
Thequestionclub,,,3,6,9,8,0.000012
Krummlauf,,,2,41,43,41,0.000011
Sonovagun,,,2,14,16,35,0.000011
Legend of Krystal,,,3,11,14,31,0.000014
Krystal Olsen,,,0,22,22,19,0.000011
Krystle Cole,,,6,9,15,10,0.00002
Kunwon1/logs2,,,1,0,1,41,0.000013
Kunwon1/logs,,,1,0,1,41,0.000013
Kuralyov,,,1,10,11,2,0.000011
Localroger,,,1,11,12,10,0.000012
Michael Crawford,,,2,16,18,10,0.000013
Kurt Eichenbald/Timeline,,,0,39,39,19,0.000011
Kusaba X,,,2,12,14,9,0.000012
Kwalah Noman,,,2,35,37,37,0.000012
No Man's Sky,,,7,8,15,49,0.000013
Mrmercedesman,,,3,25,28,48,0.000015
Machiavelli,,,8,24,32,14,0.000027
Kyle Sandilands,,,2,2,4,5,0.000011
Kyleville,,,1,5,6,35,0.000019
Kylie Jenner Lip Challenge,,,1,14,15,8,0.000011
Kynn,,,3,11,14,18,0.000011
KyraShangea,,,1,26,27,21,0.000011
Mitsusei,,,2,56,58,28,0.000011
Kytalise,,,2,60,62,39,0.000016
Rose Byrd,,,2,60,62,27,0.000013
Narufag,,,1,0,1,39,0.000011
Käpt'n Balu Und Seine Tollkühne Crew,,,2,6,8,48,0.000011
L.A. Beast,,,0,15,15,34,0.000011
L.U.L.Z.,,,0,13,13,1,0.000011
L.U.L.Z./Transcript,,,1,0,1,1,0.000011
Wikimapia,,,4,10,14,2,0.000019
L0de Radio Hour,,,4,20,24,41,0.000013
LAF,,,1,16,17,12,0.000011
LBC Lulz News,,,0,9,9,51,0.000011
LBC Lulz News/Archive,,,10,9,19,51,0.000039
"LBC Lulz News/Archive/Week of April 17, 2011",,,2,7,9,51,0.000015
"LBC Lulz News/Archive/Week of April 24, 2011",,,2,13,15,51,0.000015
"LBC Lulz News/Archive/Week of May 1, 2011",,,2,8,10,51,0.000015
"LBC Lulz News/Week of June 4, 2011",,,2,3,5,51,0.000015
"LBC Lulz News/Week of June 12, 2011",,,2,6,8,51,0.000015
"LBC Lulz News/Week of June 26, 2011",,,2,4,6,51,0.000015
"LBC Lulz News/Week of July 3, 2011",,,2,2,4,51,0.000015
"LBC Lulz News/Week of July 24, 2011",,,2,2,4,51,0.000015
LBC Lulz News/32 Anons Arrested in Turkey,,,1,1,2,51,0.000013
"LBC Lulz News/PSN Network Closed, Due to Hackers",,,2,2,4,51,0.000014
"LBC Lulz News/""For Sherrod"", By Meepsheep",,,1,0,1,51,0.000013
LBC Lulz News/ED Goes Down Temporarily,,,1,0,1,51,0.000012
LBC Lulz News/AnonOps Hit With DDoS,,,1,0,1,51,0.000012
LBC Lulz News/Gays take on Jews in Politically Correct Apocalypse,,,1,0,1,51,0.000012
LBC Lulz News/Superman Renounces US Citizenship,,,1,0,1,51,0.000012
LBC Lulz News/Ghaddafi Troops Raping and are Issued Viagra,,,1,0,1,51,0.000012
"LBC Lulz News/Beer Can Be Used For Putting Out Fires, Among Other Things",,,1,0,1,51,0.000012
Linode,,,2,7,9,8,0.000023
Mandy,,,2,45,47,3,0.000013
Viewall,,,1,4,5,8,0.000019
Tiabliaj,,,2,8,10,8,0.000015
Skulz,,,6,46,52,8,0.000018
LJ whore,,,2,21,23,8,0.000011
Windows XP Performance,,,4,6,10,10,0.000021
LOL,,,0,2,2,48,0.000011
LS Studio,,,0,25,25,22,0.000011
Endoftheinter.net,,,1,0,1,3,0.000012
LUG,,,1,6,7,42,0.000022
LUNA Online,,,3,5,8,28,0.000012
Pantykin.com,,,4,14,18,31,0.000011
Lacey Vicich,,,2,36,38,9,0.000011
Lady-JadeDragon,,,0,4,4,50,0.000011
Yeffyaboyuice,,,4,71,75,21,0.000012
Shelby Rox,,,1,40,41,7,0.000011
Laibach,,,6,32,38,37,0.000022
Lainchan,,,1,7,8,9,0.000012
Onde está Maddy? em português,,,3,42,45,47,0.000014
Lakeith Smith,,,0,7,7,35,0.000011
Lakotastan,,,1,20,21,35,0.000016
Lakwesha Jackson,,,1,4,5,4,0.000011
Lalique,,,1,4,5,56,0.000011
Lana Del Rey,,,1,38,39,12,0.000011
Lance M. Havok,,,4,37,41,10,0.000013
Volapük,,,3,4,7,2,0.000016
Lap band,,,2,8,10,52,0.000012
Large Penis Support Group,,,5,26,31,40,0.000014
Larry Ellison,,,2,3,5,10,0.000015
Larry Page,,,4,30,34,10,0.00002
The Stanford Prison Experiment,,,8,16,24,41,0.000024
The Church of Google,,,3,42,45,46,0.000017
SuperMemo,,,4,39,43,2,0.000067
Decanter,,,1,0,1,35,0.000012
The black cloud,,,2,8,10,52,0.000016
Lascivus Lutra,,,1,11,12,31,0.000011
Laska,,,0,10,10,40,0.000011
Flaunt,,,1,0,1,12,0.000011
Folk,,,1,0,1,12,0.000011
J-rap,,,1,0,1,12,0.000011
Lateral thinking,,,1,41,42,2,0.000037
Latias4ever,,,1,58,59,31,0.000011
LatinVixen,,,2,28,30,31,0.000014
Laura Bailey,,,0,9,9,28,0.000011
Tears,,,9,11,20,7,0.000013
Scrub Me Mama With A Boogie Beat,,,5,30,35,35,0.000028
Lb-69,,,6,17,23,63,0.000038
Le Monkey Face,,,5,6,11,9,0.000014
V/,,,3,234,237,9,0.000015
Le Pointy Nose Smiling Face,,,3,4,7,9,0.000013
League of an Heroes,,,0,11,11,58,0.000011
Leah Costa,,,0,3,3,59,0.000011
Lean Bodies Consulting,,,0,10,10,0,0.000011
Lucian Hodoboc,,,5,131,136,19,0.000013
LeaveMyKidzAlone,,,2,19,21,53,0.000011
Vampire Shitty,,,4,24,28,53,0.000012
Lecarick,,,2,21,23,31,0.000011
Lee L. Mercer Jr,,,3,10,13,30,0.000011
Seasonal Affective Disorder,,,2,29,31,13,0.000014
Lee Stranahan,,,1,26,27,39,0.000011
Lethal action,,,2,2,4,22,0.000016
Legend of the Cryptids,,,1,12,13,49,0.000011
Lolki,,,5,28,33,41,0.000015
McPedo,,,2,8,10,56,0.000016
Spacehero,,,5,26,31,41,0.000026
Sunshine Megatron,,,7,17,24,41,0.000016
Thespoony,,,5,20,25,8,0.000012
Sgt. Marcia Ramode,,,3,28,31,40,0.000011
The Great AFI Incident of 2007,,,6,36,42,12,0.00002
Legion of Noway,,,12,62,74,48,0.000015
Nostalgia Thread,,,4,17,21,9,0.000013
LeisureSuitGaming/NoDateGamers,,,2,0,2,61,0.000011
Top lel,,,9,15,24,9,0.000027
Under Construction,,,1,9,10,12,0.000011
Lemon pudding,,,3,2,5,41,0.000011
Lemonade,,,5,8,13,49,0.000012
Wetflame,,,4,35,39,5,0.000022
Olene,,,2,32,34,41,0.000012
Operation Lemonparty,,,2,16,18,19,0.000027
Lena Dunham/Book Draft,,,1,0,1,19,0.000011
Patriotic Eagle,,,2,1,3,9,0.000011
Lena Kochman,,,0,11,11,30,0.000011
Leo-Leonardo-III,,,2,12,14,31,0.000011
Speed Demos Archive,,,9,65,74,61,0.000015
Ween,,,1,7,8,12,0.000011
Leonassan,,,1,10,11,12,0.000011
The Vagina Monologues,,,9,43,52,39,0.000059
Maya Keyes,,,4,7,11,40,0.000026
Lesbian Two Degrees of Separation,,,3,4,7,42,0.000016
TheMrXshow,,,3,41,44,40,0.000011
Tool Assisted Speedrun,,,4,28,32,61,0.000013
Nerd Cubed,,,2,22,24,61,0.000021
Let me show you,,,2,4,6,9,0.000011
Letterboxd,,,0,36,36,19,0.000011
Lexshit Bleuuaaaargh,,,3,44,47,52,0.000011
Lia Marie Johnson,,,2,17,19,48,0.000011
Liam Sullivan,,,1,23,24,17,0.000011
Save Aaliyah,,,4,40,44,30,0.000074
Ripoff Report,,,4,27,31,15,0.000074
Liath,,,3,24,27,13,0.000013
Liberal (community),,,6,39,45,8,0.000091
Liberal quilt,,,4,5,9,14,0.000099
Talk Page Editors,,,1,66,67,2,0.000013
Nick Xenophon,,,11,16,27,14,0.000022
Tom Wood,,,3,20,23,51,0.000013
Mark B. Cohen,,,3,25,28,14,0.000014
Ron Kind,,,3,38,41,14,0.000014
Robert Anton Wilson,,,5,24,29,17,0.000015
Ron Swanson,,,1,9,10,37,0.000012
Vox Day,,,4,64,68,14,0.000013
Liberty Forest,,,2,7,9,14,0.000012
LibreOffice,,,1,5,6,10,0.000016
Lolita complex,,,1,0,1,46,0.000012
Sue Reid,,,2,6,8,36,0.000012
LifeInATent/Termsocks,,,1,43,44,36,0.000012
Lightning Warrior Raidy,,,3,14,17,62,0.000012
Lil B/Discography,,,0,19,19,46,0.000011
Lil Tay,,,0,17,17,24,0.000011
Liliana Rayne,,,1,24,25,36,0.000032
Lily Narcissa,,,1,42,43,52,0.000011
Limapal00za,,,2,18,20,48,0.000011
Limbo of the Lost,,,1,38,39,48,0.000011
Lindsay,,,0,4,4,58,0.000011
Lindsay Roberts,,,3,7,10,53,0.000017
Links,,,4,8,12,10,0.000012
Linux Mint,,,2,42,44,10,0.000011
Psychonaut,,,4,8,12,2,0.000011
Linuxwolf,,,2,15,17,31,0.000011
LionMaker Studios,,,1,14,15,20,0.000023
Lionel C. Suggs,,,1,2,3,7,0.000011
Outskirts Battle Dome,,,1,1,2,7,0.000015
Lionsgate Troll of 2006/transcript,,,1,2,3,30,0.000011
Lisa,,,1,10,11,18,0.000014
Lisa Biron,,,1,29,30,16,0.000012
Lisa Portolese,,,5,17,22,41,0.000013
Uninformed Lisa,,,4,2,6,9,0.000012
Arisuchan,,,1,0,1,9,0.000012
List of lulz wikis,,,0,84,84,2,0.000011
Wikichan/Showing /b/ to my sister,,,1,0,1,2,0.000011
"List of reasons why ED is a waste of time, promotionally",,,1,5,6,9,0.000019
Old fag,,,1,0,1,39,0.000013
Internet slang,,,1,0,1,39,0.000012
Lisztnut,,,1,15,16,0,0.000013
Lithium Junkie,,,3,39,42,26,0.000011
Moonface,,,4,17,21,1,0.000011
Shades of Ambivalence,,,1,1,2,21,0.000012
LittleCloud/Arbchat Logs,,,1,0,1,21,0.000012
LittleCloud/Comment Logs,,,1,4,5,21,0.000011
The Sagas Council,,,3,34,37,24,0.000016
Mcclane,,,1,4,5,8,0.000034
Must Be Pop,,,1,8,9,12,0.000034
Rei saru,,,1,9,10,36,0.000034
The LiveJournal War,,,1,19,20,8,0.000034
Vox,,,3,24,27,8,0.000041
The Domino's YouTube Incident,,,7,20,27,52,0.000018
Risk,,,1,0,1,32,0.000011
Living the dream,,,2,36,38,9,0.000011
Mary Moon eSchwa e-rape,,,4,21,25,55,0.000013
Liz Mair,,,1,3,4,14,0.000016
Wisdom Cat,,,2,2,4,3,0.000011
Sandworm,,,2,62,64,10,0.000017
Rx suicide,,,2,28,30,8,0.000011
Lj-cut,,,0,17,17,8,0.000011
Ljpizza party,,,5,9,14,41,0.00002
Ljseek,,,0,7,7,18,0.000011
Lmaowl,,,18,12,30,48,0.000145
Lmaonaise,,,18,13,31,48,0.000142
Lols-royce,,,15,11,26,48,0.000138
Logical Puppy,,,1,4,5,9,0.000011
Loler,,,1,9,10,3,0.000044
Luvmonkeys,,,2,53,55,34,0.000015
Swaggie--Vortex/R0B3KA789/Rebecca K. Lunetta,,,1,12,13,7,0.000015
Selene,,,1,47,48,36,0.000015
Thor,,,5,30,35,10,0.000039
Universal,,,4,66,70,37,0.000016
Ursweety,,,2,53,55,32,0.000015
Pareto's Principle,,,6,27,33,41,0.000016
Lold Man,,,2,13,15,9,0.000015
Lols-Royce,,,0,11,11,48,0.000011
Roflcraft,,,3,11,14,48,0.000011
Lomstat,,,1,24,25,31,0.000011
Office of Government Commerce (OGC),,,1,4,5,6,0.000012
Nathan's Empire,,,8,41,49,52,0.000018
Max Gogarty,,,2,29,31,41,0.000012
Zoklet,,,5,15,20,4,0.000016
MascotGuy,,,6,18,24,2,0.000014
ItsLassieTime,,,1,0,1,2,0.000012
Splongcat,,,7,63,70,26,0.000028
Look Around You,,,0,18,18,34,0.000011
Look what I found,,,3,11,14,9,0.000011
Loonatics Unleashed!,,,2,28,30,31,0.000011
Lord-Of-Death-Reiai,,,3,67,70,28,0.000011
Ravda,,,4,70,74,31,0.000011
LordZedd16,,,3,62,65,48,0.000023
Low self-esteem,,,1,0,1,48,0.000011
Cum dump,,,1,0,1,7,0.000011
ToriTheWolfy,,,4,29,33,7,0.000013
Lordshadrach,,,2,8,10,7,0.000011
Lorem Ipsum,,,0,8,8,15,0.000011
Lost Furest,,,1,14,15,31,0.000011
Louisthehedgehog,,,5,30,35,19,0.000011
LoveBugz,,,2,9,11,6,0.000018
Love Live!,,,1,57,58,19,0.000011
Shoujo,,,1,0,1,19,0.000011
Heterophobe,,,1,0,1,19,0.000011
Two girls and a boy,,,1,0,1,19,0.000011
Trash,,,1,0,1,19,0.000011
Bulshit,,,1,0,1,19,0.000011
Love Revolution,,,2,16,18,17,0.000011
Lovecrafty,,,1,25,26,8,0.000011
Loveinavoid,,,2,39,41,50,0.000011
Lowtax/YouTube,,,3,3,6,48,0.000014
LtFlagger,,,5,32,37,39,0.000023
Subspace/Continuum,,,3,69,72,32,0.000012
Lucas,,,0,4,4,33,0.000011
Lucas Werner,,,2,8,10,53,0.000013
Teen Hut,,,3,63,66,11,0.000011
Lucian Hodoboc/Chat Logs,,,1,0,1,19,0.000011
Lucyfag,,,0,7,7,12,0.000011
Lugia,,,7,25,32,31,0.000017
Shaymin,,,4,18,22,41,0.000011
Popcorn.gif,,,3,12,15,8,0.000014
Luka Magnotta/Allvoices article,,,1,0,1,25,0.000012
Luka Magnotta/press release,,,1,0,1,25,0.000012
Lukas Pietsch,,,1,10,11,2,0.000012
Robert Clark Young,,,3,11,14,2,0.000013
Lulbat,,,2,17,19,1,0.00002
Sabu/Sabuspeak,,,1,97,98,37,0.000012
NSLE,,,5,23,28,2,0.000014
Piotrus,,,5,43,48,2,0.000013
Stuart Slann,,,6,23,29,40,0.000013
Yamla,,,4,49,53,2,0.000013
Starlaglam,,,8,133,141,32,0.000012
Mariozplaze,,,3,58,61,8,0.000012
Lulzcast (old),,,1,40,41,48,0.000015
PencilLeadProductions,,,2,19,21,48,0.000011
Lulznews/Archive,,,2,11,13,3,0.000054
Lulznews/April Archive,,,1,3,4,3,0.000015
Lulznews/June Archive,,,1,1,2,3,0.000015
Lulznews/March Archive,,,1,1,2,3,0.000015
Lulznews/February Archive,,,1,3,4,3,0.000015
Lulznews/January Archive,,,1,2,3,1,0.000015
Lulznews/December Archive,,,1,1,2,3,0.000015
Lulznews/November Archive,,,1,1,2,3,0.000015
Lulznews/October Archive,,,1,4,5,9,0.000015
LunaMatsu,,,0,19,19,53,0.000011
Maureen O'Gara,,,2,5,7,10,0.000015
OpenGraphics,,,2,7,9,10,0.000015
Main Page (text only),,,1,3,4,8,0.000014
NetWare,,,1,13,14,10,0.000014
LyinBrian,,,2,24,26,21,0.000016
Lyndsay Kirkham,,,0,20,20,39,0.000011
Lynzee Stauss,,,3,45,48,36,0.000013
M.C. Too Tall,,,0,5,5,15,0.000011
SNK,,,2,22,24,49,0.000011
Mushroom Kingdom Fusion,,,5,109,114,49,0.000023
M/F?,,,0,10,10,3,0.000011
M0M0ko,,,2,102,104,28,0.000011
Ur,,,1,0,1,28,0.000011
M3,,,3,24,27,31,0.000012
MCM,,,2,19,21,31,0.000011
MDK,,,5,74,79,49,0.000014
MDK/fixed,,,1,26,27,32,0.000011
MDetector5/BOYCOTT MDETECTOR5 NOW!!!,,,1,3,4,21,0.000011
SigurdHosenfeld,,,4,74,78,21,0.000011
Hbomberguy,,,1,0,1,52,0.000011
Encyclopedia Dramatica:ED Is Not,,,2,0,2,52,0.000012
The Warriors,,,4,0,4,31,0.000011
MGM,,,1,4,5,48,0.000011
Mara Mercer,,,1,1,2,19,0.000011
MKV,,,2,10,12,10,0.000012
MLB.tv,,,1,54,55,35,0.000011
RealPlayer,,,2,3,5,10,0.000011
MLK day raid,,,1,23,24,35,0.000011
IBrony,,,1,0,1,7,0.000011
PonyIsland,,,6,71,77,23,0.000012
Mabinogi,,,4,110,114,60,0.000014
PlaneShift,,,2,72,74,31,0.000012
Sakra,,,2,1,3,49,0.000012
Pangya,,,3,47,50,49,0.000012
Progress Quest,,,4,12,16,49,0.000017
Whirled,,,5,93,98,33,0.000014
Monster Ranch Online,,,2,35,37,16,0.000012
Habit,,,1,0,1,49,0.000011
MONGO/HowToAsk,,,1,1,2,2,0.000014
MONGO/EvidenceRepository1,,,1,1,2,2,0.000014
MONGO/Factual,,,3,12,15,2,0.000014
PROJECT CHANOLOGY/IRL PROTEST PAGE/AUSTRALASIA,,,6,10,16,1,0.00002
MRirian/Quotes,,,1,0,1,51,0.000012
MRirian/Interviews,,,1,1,2,51,0.000012
MS-13,,,1,43,44,19,0.000013
Prosthetic Penis,,,9,10,19,40,0.00002
TV Tropes/Horrible FanficsA-D,,,7,6,13,2,0.000038
Text-adventure,,,1,0,1,31,0.000011
TinyTIM,,,3,9,12,31,0.000016
MUMPS,,,1,4,5,10,0.000012
MY NAME IS X AND I WILL HAVE MY Y!,,,3,20,23,9,0.000015
MZMcBride/Going Rogue,,,1,3,4,2,0.000011
MZMcBride/How to sock,,,2,4,6,2,0.000011
Mackeeper,,,0,8,8,41,0.000011
Maddi,,,3,30,33,36,0.000015
Rizbow,,,2,5,7,35,0.000011
Made in Abyss,,,0,66,66,53,0.000011
Madeira,,,1,18,19,28,0.000011
Madeleine Albright,,,0,29,29,19,0.000011
Madlovesong,,,1,15,16,53,0.000011
Wikipedia Sandbox,,,3,11,14,63,0.000011
MagicalPockyUsagi,,,2,23,25,28,0.000011
Usva,,,1,10,11,27,0.000013
Magicrich,,,0,12,12,11,0.000011
Preteen Chat,,,3,8,11,47,0.000012
Magnus,,,0,20,20,31,0.000011
Tommy Gorman,,,8,30,38,26,0.000012
Mahathir bin Mohamad,,,1,32,33,37,0.000011
Mahoiku,,,0,46,46,28,0.000011
Main Page/did you know,,,2,20,22,19,0.000113
Main Page/2017,,,0,1,1,7,0.000011
"Main Page/April 1, 2007",,,1,27,28,46,0.000011
Main Page/ED:BNA/A,,,0,1,1,7,0.000011
R4EDICAL,,,4,23,27,7,0.000021
Main Page/ED:BNA/C,,,0,1,1,9,0.000011
Main Page/ED:BNA/D,,,0,1,1,2,0.000011
Main Page/ED:BNA/F,,,0,1,1,34,0.000011
Theme Park Review,,,1,14,15,34,0.00002
Main Page/ED:BNA/G,,,0,1,1,13,0.000011
Main Page/ED:BNA/H,,,0,1,1,58,0.000011
Main Page/ED:BNA/I,,,0,1,1,37,0.000011
Main Page/ED:BNA/J,,,0,1,1,28,0.000011
Main Page/ED:BNA/K,,,0,1,1,4,0.000011
Main Page/ED:GNA,,,1,5,6,19,0.000015
Main Page/ED:GNA/A,,,0,1,1,19,0.000011
Main Page/ED:GNA/B,,,0,1,1,53,0.000011
Main Page/ED:GNA/C,,,0,1,1,19,0.000011
Main Page/ED:GNA/D,,,0,1,1,19,0.000011
Main Page/ED:GNA/E,,,0,1,1,35,0.000011
Main Page/ED:GNA/F,,,0,1,1,37,0.000011
Main Page/ED:GNA/G,,,0,1,1,0,0.000011
Main Page/ED:GNA/H,,,0,1,1,36,0.000011
Main Page/ED:GNA/I,,,0,1,1,37,0.000011
Main Page/ED:GNA/J,,,0,1,1,58,0.000011
Main Page/ED:GNA/K,,,0,1,1,37,0.000011
Main Page/ED:GNA/L,,,0,1,1,30,0.000011
Main Page/Ideas,,,1,5,6,44,0.000011
Main Page/Lists,,,0,25,25,44,0.000011
Main Page/Featured Portal/1,,,1,0,1,44,0.000011
Main Page/Featured Portal/13,,,1,0,1,44,0.000011
Main Page/Featured Portal/23,,,1,0,1,44,0.000011
Main Page/Featured Portal/24,,,1,0,1,44,0.000011
Main Page/Featured Portal/25,,,1,0,1,44,0.000011
Main Page/Featured Portal/27,,,1,0,1,44,0.000011
Main Page/Featured Portal/28,,,1,0,1,44,0.000011
Main Page/Featured Portal/29,,,1,0,1,44,0.000011
Main Page/Featured Portal/30,,,1,0,1,44,0.000011
Main Page/Featured Portal/31,,,1,0,1,44,0.000011
Main Page/Featured Portal/8,,,1,0,1,44,0.000011
Main Page/did you know/41,,,1,8,9,44,0.000011
Main Page/did you know/42,,,1,6,7,31,0.000011
Main Page/did you know/43,,,1,7,8,31,0.000011
Main Page/did you know/44,,,1,7,8,14,0.000011
Main Page/did you know/45,,,1,8,9,10,0.000011
Main Page/did you know/46,,,1,11,12,49,0.000011
Main Page/did you know/47,,,1,8,9,14,0.000011
Main Page/did you know/49,,,1,0,1,44,0.000011
Main Page/did you know/50,,,1,0,1,44,0.000011
Main Page/did you know/Archives,,,1,9,10,44,0.000011
Main Page/netbattle,,,1,0,1,44,0.000011
Main Page/temp,,,1,0,1,44,0.000011
Main Page/contact,,,1,3,4,59,0.000014
Main Page/did you know/48,,,0,8,8,14,0.000011
Main Page/did you know/51,,,0,7,7,37,0.000011
Main Page/flexbox,,,0,1,1,19,0.000011
Main Page/footer,,,0,3,3,59,0.000011
Main Page/fp,,,0,3,3,37,0.000011
Main Page/header,,,0,2,2,11,0.000011
Main Page/in the news,,,0,1,1,14,0.000011
Main Page/tomorrow,,,0,2,2,19,0.000011
Main page/Recentlyfeatured,,,0,1,1,9,0.000011
MajelaZeZeDiamond,,,4,9,13,64,0.000012
Majira Strawberry,,,2,11,13,31,0.000011
Make Sex,,,2,10,12,9,0.000014
Making Fiends,,,1,7,8,34,0.000011
Malaysia Airlines,,,0,2,2,58,0.000011
Maleificus,,,0,19,19,39,0.000011
Malik Obama,,,2,21,23,19,0.000014
Mallory,,,0,2,2,39,0.000011
Paris Brown,,,1,6,7,42,0.000022
Mana Maiden,,,6,39,45,24,0.000012
Michael Batton,,,1,35,36,24,0.000012
Mandaxface,,,2,27,29,36,0.000015
Setsuna Toushirou,,,6,69,75,39,0.000015
Manlytears/BritbongReturns Second Life Wiki,,,1,8,9,7,0.000011
The Wrong Hands,,,3,77,80,31,0.000014
Manos: The Hands of Fate,,,0,24,24,38,0.000011
Oh shit i'm sorry i meant,,,3,7,10,9,0.000011
Manzes,,,0,9,9,30,0.000011
Maoist Rebel News,,,1,25,26,37,0.000012
Nail in the coffin,,,1,0,1,34,0.000011
Rice nigger,,,1,0,1,34,0.000011
MapleStory Clones,,,2,22,24,49,0.000011
MustDestroyAll,,,2,26,28,7,0.000011
Marcabian Armaments,,,1,59,60,9,0.000012
MarcosPower1996,,,1,31,32,7,0.000011
Tommypezmaster,,,4,8,12,7,0.000012
Näshulta Thugs,,,2,12,14,35,0.000011
Mariah Anderson,,,2,14,16,38,0.000019
Reconquista,,,5,38,43,35,0.000022
Orsl,,,1,0,1,35,0.000012
Pun Raccoon,,,2,3,5,9,0.000012
Mario Paint,,,4,12,16,49,0.000013
YoYo Games,,,3,30,33,49,0.000011
Mariozplaze/defendthechildren,,,1,0,1,8,0.000011
Mariozplaze/dadcharges,,,1,0,1,8,0.000011
Marissa Marchant,,,1,6,7,35,0.000016
Parkland Coffee House Spree,,,4,42,46,1,0.000011
Mark Bradford,,,1,14,15,49,0.000011
Mark Prindle,,,3,54,57,2,0.000011
Porn Wiki Leaks/Mark Spiegler,,,3,3,6,0,0.000014
Mark Foley/Chat Logs,,,3,2,5,39,0.000014
No you sign off first,,,1,5,6,8,0.000014
Purgatory,,,1,0,1,2,0.000011
Melting pot,,,1,0,1,2,0.000011
Mark fratzke,,,0,1,1,9,0.000011
Marky Thompson,,,0,11,11,46,0.000011
The Princess of /b/,,,3,7,10,8,0.000012
Subeta/Lies of Subeta,,,2,4,6,6,0.000011
Marshall County High School shooting,,,0,10,10,58,0.000011
Martin,,,0,9,9,2,0.000011
The Comprehensive Guide To Being A Party Animal,,,2,11,13,13,0.000011
Martyn Lee Ball,,,1,37,38,21,0.000011
MaruMariMaru,,,2,90,92,21,0.000012
Operation Close The Pool,,,3,16,19,9,0.000021
ESchwa BBS,,,1,0,1,55,0.000011
Play-Bys,,,6,44,50,36,0.00002
Mason Reed,,,1,25,26,0,0.000011
Mass Carrier,,,3,31,34,60,0.000011
Once Upon a Time,,,1,8,9,53,0.000011
SGT FOLEY,,,4,2,6,49,0.000011
Stock photography,,,3,37,40,9,0.000013
Matlab,,,0,13,13,10,0.000011
Matt Hickey,,,0,15,15,19,0.000011
Matt Shizzle,,,4,26,30,46,0.000012
Matt Ward,,,3,7,10,21,0.000011
Matthew,,,0,20,20,43,0.000011
The Rise and Fall of Nickelodeon,,,3,86,89,34,0.000012
Matthias Schoormann,,,1,12,13,12,0.000011
Mavica Sprite,,,3,8,11,9,0.000011
Maxofs2d,,,1,77,78,49,0.000011
RUST,,,3,9,12,49,0.000011
Morgan Spurlock,,,1,38,39,0,0.000016
MeatballWiki,,,3,57,60,2,0.000013
WikiWikiWeb,,,3,31,34,2,0.000013
Spin,,,3,10,13,3,0.000018
Meatspin.com/Backup,,,1,0,1,6,0.000016
Pete Burns,,,1,1,2,6,0.000016
MechaShockwave,,,1,95,96,7,0.000011
Asskissing,,,1,0,1,7,0.000011
Robokin,,,1,19,20,8,0.000012
Media Transfer Protocol,,,0,19,19,10,0.000011
Mediacrat Voicemails,,,2,22,24,8,0.00002
Mediatakeout,,,2,23,25,0,0.000036
Rodney Caston,,,2,21,23,28,0.000011
Megachiropetra69,,,1,14,15,18,0.000011
Megan,,,0,8,8,36,0.000011
Save,,,4,5,9,54,0.000037
MsHeartAttack,,,4,15,19,36,0.000012
Switchiedagger,,,3,16,19,41,0.000011
Megan Meier/Poetry,,,1,9,10,39,0.000012
Paul Tilley,,,2,5,7,26,0.000012
Megan Meier/Megan Meier of Bel-Air,,,1,12,13,52,0.000012
MegatronPwnsYou,,,3,20,23,49,0.000011
RDK,,,4,28,32,49,0.000012
Welp,,,3,8,11,29,0.000018
Robinson Gill Lawyers,,,1,0,1,12,0.000011
Melinda and Marshall Castersen,,,0,5,5,17,0.000011
This Fuckin' Guy,,,1,5,6,9,0.00003
"Собака Бэ бэ бэээ",,,4,10,14,9,0.00002
Meme Detection,,,1,22,23,9,0.000011
Meme War,,,1,9,10,49,0.000011
Memebase,,,3,23,26,31,0.000013
Memedates,,,1,25,26,38,0.000011
Memories-long-gone,,,1,51,52,21,0.000011
Meo,,,0,44,44,10,0.000011
Meow Wars/Deleted Wikipedia article,,,1,13,14,41,0.000012
E-mail spam,,,1,0,1,41,0.000011
Electronic mail,,,1,0,1,41,0.000011
Anonymous remailer,,,1,0,1,41,0.000011
Performance art,,,1,0,1,41,0.000011
Control message,,,1,0,1,41,0.000011
Digital signature,,,1,0,1,41,0.000011
Screenname,,,1,0,1,41,0.000011
Steganography,,,1,0,1,41,0.000011
Meowbark,,,4,26,30,28,0.000017
Mercedes Herrera,,,0,16,16,36,0.000011
Mere Doyle,,,2,36,38,28,0.000016
Wikipedia's Greatest Hits Food,,,2,9,11,2,0.000012
"Растишка",,,1,33,34,17,0.000011
WatchMojo.com,,,5,27,32,34,0.000017
RavenNG,,,3,30,33,7,0.000013
Metal Reviews,,,2,9,11,8,0.000011
Metal Gear Online,,,2,93,95,49,0.000011
SSSniperWolf,,,3,14,17,39,0.000013
Metal Gear Rising: Revengeance,,,0,54,54,63,0.000011
MetallicTuneFilms,,,1,24,25,34,0.000011
Metamodernism,,,0,10,10,10,0.000011
Tao Lin,,,1,10,11,2,0.000012
PTSD Clarinet Boy,,,3,2,5,9,0.000013
Teranoid,,,1,0,1,40,0.000011
Girls clothing,,,1,0,1,40,0.000011
E-girls,,,1,0,1,40,0.000011
Mewchan,,,3,18,21,9,0.000014
NANACA†CRASH!!,,,2,54,56,56,0.000011
Roberto Madrazo's Berlin marathon scam,,,1,9,10,35,0.000015
Mini Daddy,,,1,5,6,35,0.000015
Meximoot,,,3,7,10,9,0.000016
MexisxReitaxchan,,,2,24,26,40,0.000016
Mia Brown,,,0,27,27,19,0.000011
Mic.com,,,0,9,9,19,0.000011
Upworthy,,,4,66,70,14,0.000012
Michael Carneal,,,3,27,30,58,0.000013
Michael Oman-Reagan,,,1,5,6,5,0.000011
Porn Wiki Leaks/Michael Whiteacre,,,1,0,1,14,0.000011
Michael Bennett,,,0,17,17,35,0.000011
Michael Fitzhywel,,,5,23,28,19,0.000013
Michael Horowitz/Arbchat,,,1,1,2,2,0.000012
Thatkidparker,,,6,36,42,48,0.000015
Jewed,,,1,0,1,53,0.000013
Online Blackjack,,,8,68,76,23,0.000016
Michael McHugh,,,0,11,11,37,0.000011
Televised,,,1,0,1,9,0.000011
National debt,,,1,0,1,9,0.000011
Michael Pousti,,,1,8,9,64,0.00002
Michael Reagan,,,1,23,24,14,0.000013
Michael Righetti,,,1,67,68,31,0.000011
Michael Rowlands,,,1,3,4,19,0.000012
Tim Blake,,,1,11,12,19,0.000014
Michael Woodmansee,,,3,26,29,22,0.000038
The Gay Pimp,,,3,39,42,40,0.000012
Mickey Avalon,,,2,37,39,11,0.000012
Microaggression,,,2,2,4,19,0.000012
Microsoft Surface,,,1,5,6,10,0.000027
Midnight-Fantom,,,3,99,102,7,0.000011
Mike-the-cat,,,1,71,72,49,0.000011
Migraine,,,1,2,3,36,0.000012
Miimosa,,,0,8,8,1,0.000011
Miiverse,,,3,7,10,49,0.000015
Same,,,4,3,7,19,0.000016
MikeNnemonic,,,0,43,43,0,0.000011
Mike Reed's Flame Warriors,,,0,3,3,41,0.000011
Oldmencrying.com,,,3,19,22,41,0.000011
Mikki Willis,,,0,4,4,50,0.000011
Mila Mortice,,,1,9,10,1,0.000011
MilanaMill,,,3,67,70,7,0.000011
The Hivemind Corollary,,,2,7,9,14,0.000014
Milli Vanilli,,,1,8,9,41,0.000011
Million Mask March,,,1,8,9,26,0.000011
Milo Yiannopoulos/Feminist Version,,,0,26,26,19,0.000011
Trendpedia,,,4,24,28,31,0.000016
Miltopia Hates Non-Internet-Related Articles,,,2,2,4,19,0.000028
MinTails,,,2,19,21,21,0.000011
MindWipe,,,1,21,22,33,0.000011
MindfangVevo,,,0,40,40,36,0.000011
Minecraft/Aspergium,,,1,0,1,20,0.000011
Yogscast,,,2,8,10,20,0.000012
Minecraft Forums,,,2,29,31,7,0.000011
Mini-chan,,,0,10,10,9,0.000011
Ministry of LOL,,,0,8,8,1,0.000011
Spike Can Dance,,,2,25,27,56,0.00002
Mintah,,,3,15,18,41,0.000011
Minxthecheetah,,,1,8,9,7,0.000011
Viscerotonictsf,,,5,19,24,7,0.000014
Mircea Kitsune,,,3,43,46,31,0.000014
Wikipedia's censored guide to CP laws,,,5,9,14,2,0.000012
MirrorZan,,,5,81,86,24,0.000012
Nurelli,,,3,32,35,24,0.000011
Misha,,,0,2,2,43,0.000011
Valerie (Pai),,,3,20,23,28,0.00002
Miss Hitler 2014,,,0,13,13,37,0.000011
Miss Landmine,,,2,20,22,36,0.000017
Miss Victoria Murder,,,0,6,6,59,0.000011
Mission: MySpace,,,0,117,117,41,0.000011
Wholesome family environment,,,1,0,1,35,0.000012
Misticvitamin,,,1,7,8,9,0.000011
Misty Chronexia,,,0,44,44,28,0.000011
Mistyeyesxx,,,1,70,71,21,0.000011
Mitch,,,3,14,17,21,0.000013
Mitch Mcconnell,,,0,3,3,37,0.000011
Mitchell Rasansky,,,4,6,10,56,0.000013
Mizzou,,,2,18,20,35,0.000011
MochironMan,,,4,38,42,31,0.000011
Molests,,,1,0,1,31,0.000011
Tots,,,1,0,1,31,0.000011
Model M keyboard,,,0,17,17,32,0.000011
Mogalful,,,1,17,18,15,0.000011
Raoul DeMarest,,,4,26,30,46,0.000014
YouTube Deaf Jam,,,3,6,9,48,0.000011
Unrealistic expectation,,,1,0,1,7,0.000011
Monkids,,,3,33,36,35,0.000019
Monster Girl Quest,,,4,29,33,6,0.000011
Monster Musume no Iru Nichijou,,,3,42,45,28,0.000011
Montagraph/YouTube Channels,,,1,2,3,17,0.000011
Moonrise,,,0,16,16,36,0.000011
Roy Moore,,,1,52,53,35,0.000014
Moore Tornado,,,0,26,26,6,0.000011
Weathercat,,,4,5,9,6,0.000011
New York Nurse,,,1,19,20,26,0.000017
Wikiversity,,,4,31,35,2,0.000016
Morgan Bye,,,2,17,19,53,0.000026
Morganphantom15,,,2,45,47,21,0.000011
Moromillas,,,2,27,29,7,0.000011
My Tank is Fight,,,3,6,9,61,0.000015
Vaginal,,,1,0,1,49,0.000012
Morton Devonshire,,,4,12,16,41,0.000012
Motor Oil,,,1,18,19,40,0.000014
ScrewAttack/Former Talent,,,1,59,60,19,0.000011
ScrewAttack/ScrewAttack Shows,,,1,0,1,19,0.000011
Lulcow,,,1,0,1,1,0.000011
So I moved to the Yukon,,,4,13,17,13,0.000012
Mozdoc,,,1,11,12,31,0.000011
Urban Dead,,,2,15,17,49,0.000012
TF,,,3,4,7,49,0.000012
Mr.A.T.AndreiThomas,,,1,20,21,34,0.000011
Mr. Liqz,,,0,45,45,51,0.000011
Mr. Torgue,,,0,11,11,7,0.000011
Shannon West,,,1,66,67,49,0.000011
MrCromartie1989,,,0,3,3,1,0.000011
Yoshi,,,2,6,8,49,0.000014
UnMaskingTheTruth,,,3,24,27,7,0.000013
Mr Pregnant,,,2,20,22,48,0.000011
Exurb1a,,,1,0,1,48,0.000011
Mrpunchdrunk1,,,1,1,2,48,0.000011
Mrpunk2u,,,1,3,4,15,0.000011
Red Leader,,,3,7,10,53,0.000011
Muddy Dicks,,,0,2,2,63,0.000011
Nerdy-chan,,,2,21,23,9,0.000012
Muffdaddy2,,,1,26,27,8,0.000011
Mullah Omar,,,0,1,1,37,0.000011
The Iceman,,,4,25,29,30,0.000015
Curechan,,,1,0,1,19,0.000011
Oops,,,1,0,1,19,0.000011
Spez,,,1,1,2,19,0.000011
Triggerfox,,,4,84,88,31,0.000011
Poopfist,,,1,8,9,12,0.000012
Ultimate Guitar,,,3,69,72,12,0.000013
Yatta,,,5,3,8,12,0.000013
Musically Oblivious 8th Grader,,,2,9,11,7,0.000011
Cynical,,,1,0,1,37,0.000011
SammyDS,,,2,46,48,37,0.000011
Mutescream,,,3,32,35,10,0.000011
My-Little-Account,,,0,6,6,19,0.000011
MyCrib,,,2,12,14,12,0.000011
Buttsecs,,,1,0,1,48,0.000011
MyNameIsLenny,,,3,37,40,36,0.000011
TagWorld,,,2,6,8,6,0.000015
MySpace Newsletter,,,2,26,28,3,0.000015
Salute,,,1,14,15,8,0.000015
MySpace/Layout,,,1,2,3,12,0.000015
Truth Box,,,1,28,29,16,0.000015
ZuuP,,,2,20,22,12,0.000015
MySpace Boy,,,2,3,5,59,0.000011
MySpace Trackers,,,2,11,13,12,0.000011
MyWeb,,,3,8,11,8,0.000014
Encyclopedia Dramatica:Needed,,,2,0,2,64,0.000013
QFT,,,3,2,5,39,0.000013
My Immortal/Chapter1-11,,,5,44,49,12,0.000012
My Immortal/Chapter12-22,,,5,55,60,12,0.000012
My Immortal/Chapter23-33,,,5,40,45,36,0.000012
My Immortal/Chapter34-44,,,5,45,50,12,0.000012
My Immortal/My Immortal 2,,,1,0,1,12,0.000012
Steak,,,1,0,1,12,0.000011
My Lands,,,0,18,18,49,0.000011
My Life Is Twilight,,,2,17,19,32,0.000013
Ponyland Drama,,,4,35,39,24,0.000017
Princess Molestia,,,4,45,49,7,0.000085
My Little Pony: Equestria Girls,,,0,51,51,7,0.000011
My Posting Career,,,3,38,41,8,0.000012
Roissy,,,1,10,11,39,0.000011
My cherry crush,,,0,12,12,31,0.000011
White Helmets,,,1,57,58,37,0.000011
Myboss,,,2,22,24,48,0.000012
Mykel Lande,,,3,28,31,36,0.000012
MylarBalloonFan/Danish,,,1,31,32,7,0.000011
The Græt Niggercide of Old ED,,,2,34,36,35,0.000015
MzClueless,,,0,6,6,21,0.000011
MzDominica,,,3,17,20,36,0.000011
Radu Privantu,,,1,31,32,6,0.000015
NOAA,,,4,15,19,46,0.000013
Nafedude,,,0,14,14,19,0.000011
NaokoElric2250,,,0,68,68,3,0.000011
Narcissa Wright,,,0,39,39,19,0.000011
Naruyamcha,,,1,6,7,58,0.000011
TheRandom500,,,2,9,11,19,0.000011
Rdtheproductions,,,1,1,2,7,0.000011
"Сосач",,,1,0,1,28,0.000011
Nate,,,0,15,15,7,0.000011
NateFlicks,,,1,1,2,7,0.000011
NateFlazh1000,,,1,13,14,7,0.000011
Nathan,,,0,19,19,2,0.000011
Nathan Larson,,,3,60,63,2,0.000012
Induction,,,1,0,1,2,0.000011
Authoritarian,,,1,0,1,2,0.000011
Ljdrama.org,,,1,0,1,8,0.000012
Nathaniel,,,2,20,22,9,0.000011
Nathanr/Timeline,,,1,27,28,2,0.000012
Euphoric,,,1,0,1,19,0.000011
Natsuko-kun,,,1,34,35,24,0.000011
Nav/Asalieri,,,0,5,5,61,0.000011
Navid,,,5,10,15,9,0.000023
NaviiNeko,,,3,47,50,9,0.000011
The Church of Creativity,,,3,15,18,35,0.000025
Nc,,,1,6,7,41,0.000015
Fkn,,,1,0,1,41,0.000013
Nch85,,,2,12,14,9,0.000012
Neal Rauhauser,,,1,24,25,14,0.000011
The Many-worlds interpretation,,,1,13,14,46,0.000011
Neck,,,1,2,3,4,0.000015
PlayStation Network,,,2,23,25,49,0.000015
Necro (rapper),,,2,34,36,12,0.000016
Robert H. Marko,,,3,12,15,31,0.000013
Necromouse,,,2,2,4,22,0.000016
Neha Chhetri,,,0,10,10,19,0.000011
Neil,,,1,5,6,1,0.000011
Smith,,,1,10,11,9,0.000011
Shooker,,,1,0,1,28,0.000011
Nell,,,2,9,11,8,0.000013
Neotomi,,,4,43,47,38,0.000011
NeoPets: The Darkest Faerie,,,0,22,22,38,0.000011
Neogrant,,,0,9,9,8,0.000011
Super Robot Wars,,,4,80,84,28,0.000017
Neonlover2000,,,0,3,3,7,0.000011
NephilimFree/Debate Sagas,,,4,27,31,46,0.000013
NephilimFree/Misc.Asshattery,,,4,10,14,46,0.000013
NephilimFree/The Anniepies Documents,,,3,16,19,46,0.000011
Nessalu,,,1,14,15,48,0.000011
ObscenityCrimes.org,,,2,11,13,6,0.000011
Net Nanny,,,0,13,13,17,0.000011
Virgins vs Virgin,,,3,11,14,9,0.000021
WannaCry,,,1,19,20,17,0.000011
Orz,,,1,19,20,28,0.000011
Neuro,,,1,16,17,10,0.000011
New Categories,,,0,3,3,2,0.000011
Sheld999,,,1,17,18,59,0.000012
Newfie,,,1,8,9,7,0.000012
Accent,,,1,0,1,7,0.000012
Newgrounds/BBS/Aura,,,1,18,19,12,0.000011
Newgrounds/BBS/Forums,,,1,53,54,16,0.000011
Newgrounds/BBS/Mods,,,2,41,43,0,0.000012
Newgrounds/administration/becomeedumacated,,,0,6,6,39,0.000011
Newgrounds/administration/gitskooled,,,0,21,21,4,0.000011
Newgrounds/administration/intro,,,0,2,2,21,0.000011
Newgrounds/administration/lernmoar,,,0,1,1,34,0.000011
Newgrounds/alsococks/other,,,0,29,29,4,0.000011
Newgrounds/theflashportal/archive,,,0,29,29,12,0.000011
Newgrounds/theflashportal/blammed,,,0,7,7,13,0.000011
Newgrounds/theflashportal/intro,,,0,17,17,4,0.000011
Newgrounds/theflashportal/reviewsystem,,,0,2,2,50,0.000011
Newgrounds/theflashportal/trolls,,,0,25,25,0,0.000011
Newgrounds/theflashportal/votingsystem,,,0,11,11,4,0.000011
Newgrounds/theflavorsoffailure/historyofjewgrounds,,,0,6,6,40,0.000011
Newgrounds/theflavorsoffailure/theantilulzera,,,0,19,19,15,0.000011
Newgrounds/theflavorsoffailure/theimaginarywarsera,,,0,46,46,1,0.000011
Paintball,,,2,21,23,35,0.000015
Newgrounds/theflavorsoffailure/thelulzera,,,0,12,12,9,0.000011
Ngage,,,3,21,24,49,0.000012
Ngcb,,,0,16,16,3,0.000011
File:Pekka the finnisher.jpg,,,3,0,3,58,0.000012
NiGHTS into Dreams,,,2,34,36,21,0.000011
Niceifarted2,,,0,5,5,7,0.000011
Nicholas Giampa,,,0,59,59,19,0.000011
Shon Terry,,,4,32,36,12,0.000012
Nick,,,0,14,14,19,0.000011
Diapers,,,1,0,1,48,0.000011
Nick Chaleunphone/Chat logs,,,0,2,2,24,0.000011
Nick Offerman,,,0,2,2,36,0.000011
"United States of Australia/Advance Australia Fair, Not Yellow",,,1,0,1,14,0.000012
Nickidewbear,,,1,12,13,7,0.000012
Nicolepiepuffed01,,,0,5,5,53,0.000011
Nigger/Gallery,,,1,33,34,35,0.000023
P.A. Palace,,,4,60,64,35,0.000024
TightRope,,,2,22,24,39,0.000024
Niggers tongue my anus,,,1,20,21,9,0.000011
Nigglypuff,,,2,8,10,35,0.000013
Nihil,,,1,2,3,59,0.000013
Nikauri-susi,,,2,14,16,3,0.000011
Nikki1975,,,0,11,11,36,0.000011
Nikky Raney,,,2,144,146,1,0.000011
Nimda,,,0,13,13,6,0.000011
Filmboards,,,1,0,1,6,0.000011
Ninjas can't catch you,,,2,16,18,9,0.000013
Ninjo-Starr,,,1,6,7,19,0.000013
Ninjustupower,,,1,40,41,21,0.000011
NintendoLife,,,1,1,2,0,0.000011
Wii60,,,5,49,54,49,0.000013
Nintendo Labo,,,2,13,15,49,0.000011
VK,,,1,3,4,59,0.000011
Nitrobandicoot,,,1,42,43,31,0.000011
No Bullshit,,,1,17,18,52,0.000011
Solitaire,,,2,33,35,30,0.000017
No one will ever find this page,,,0,5,5,37,0.000011
Nobrain.dk,,,2,13,15,6,0.000013
Noby Noby Boy,,,1,11,12,49,0.000011
Normandy,,,2,15,17,2,0.000014
Ilu,,,1,0,1,2,0.000011
Red October,,,1,4,5,54,0.000012
Nostalgia Wikipedia,,,1,5,6,2,0.000011
NotKat,,,0,13,13,48,0.000011
Notepad++,,,0,8,8,10,0.000011
Poko fister,,,7,11,18,8,0.000021
Marital aid,,,1,0,1,10,0.000011
Quantum,,,2,5,7,3,0.000013
Vfallenangelv,,,1,14,15,8,0.000011
Nrvnqsr Chaos,,,0,4,4,9,0.000011
Outrage Culture,,,3,5,8,19,0.000013
Vox Media,,,4,24,28,19,0.000013
Sick Puppies,,,1,7,8,39,0.000011
Puddles,,,3,25,28,30,0.000012
Nude Greg,,,1,5,6,1,0.000012
Nurse-kun/Damaged Goods/Chapter 1,,,3,1,4,53,0.000053
Nurse-kun/Damaged Goods/Chapter 2,,,4,2,6,53,0.000096
Nurse-kun/Damaged Goods/Chapter 3,,,4,2,6,53,0.00009
Nurse-kun/Damaged Goods/Chapter 4,,,4,2,6,53,0.000087
Nurse-kun/Damaged Goods/Chapter 5,,,4,2,6,53,0.000085
Nurse-kun/Damaged Goods/Chapter 6,,,4,2,6,53,0.000084
Nurse-kun/Damaged Goods/Chapter 7,,,4,2,6,53,0.000084
Nurse-kun/Damaged Goods/Chapter 8,,,4,2,6,53,0.000083
Nurse-kun/Damaged Goods/Chapter 9,,,4,2,6,53,0.000083
Nurse-kun/Damaged Goods/Chapter 10,,,4,2,6,53,0.000082
Nurse-kun/Damaged Goods/Chapter 11,,,4,2,6,53,0.000082
Nurse-kun/Damaged Goods/Chapter 12,,,4,2,6,53,0.000081
Nurse-kun/Damaged Goods/Chapter 13,,,4,2,6,53,0.000079
Nurse-kun/Damaged Goods/Chapter 14,,,4,2,6,53,0.000076
Nurse-kun/Damaged Goods/Chapter 15,,,4,2,6,53,0.000071
Nurse-kun/Damaged Goods/Chapter 16,,,4,2,6,53,0.000061
Nurse-kun/Damaged Goods/Chapter 17,,,4,3,7,53,0.000066
Nurse-kun/Damaged Goods/Chapter 18 (Fake Thread),,,4,2,6,53,0.000065
Nurse-kun/Damaged Goods/Chapter 19,,,5,2,7,53,0.00008
Nurse-kun/Damaged Goods/Chapter 20,,,4,2,6,53,0.000093
Nurse-kun/Damaged Goods/Chapter 21,,,5,2,7,53,0.000108
Nurse-kun/Damaged Goods/Chapter 22,,,3,2,5,53,0.000059
Nurse-kun/Damaged Goods/Chapter 23,,,3,1,4,53,0.000037
Manhood,,,1,0,1,53,0.000011
Nutella,,,0,10,10,34,0.000011
Nuzlocke,,,2,104,106,15,0.000014
NuzzieKoma,,,0,17,17,7,0.000011
Nuzzlefuzzle,,,8,65,73,31,0.000015
StrongPawz,,,2,31,33,31,0.000011
Furpiles,,,1,0,1,31,0.000011
O'Reilly James Flowers,,,0,10,10,2,0.000011
O'Reilly James Flowers/Pastafarianism,,,1,0,1,2,0.000012
O'Reilly James Flowers/Personal Journal of Pales,,,1,0,1,2,0.000012
O'Reilly James Flowers/Fool's Journey,,,1,0,1,2,0.000012
Talking head,,,1,0,1,14,0.000011
Wesley Willis,,,5,25,30,32,0.000014
Odumcarlock,,,4,18,22,41,0.000016
Rogues Gallery,,,3,10,13,26,0.000033
Chasity belt,,,1,0,1,49,0.000011
Teenage Tourettes Camp,,,3,2,5,6,0.000012
Objective-C,,,1,6,7,10,0.000011
ObscureGET,,,3,8,11,9,0.000011
Occupy Democrats,,,2,39,41,19,0.000012
Occupy Silicon Valley,,,0,8,8,9,0.000011
Tfiles,,,1,0,1,41,0.000015
Heptop,,,1,0,1,41,0.000015
Odayga,,,1,22,23,21,0.000011
Odumcarlock/Odum's BMI,,,2,2,4,41,0.000011
OfficialGATG,,,1,35,36,7,0.000011
Wayah,,,3,32,35,31,0.000012
Cis female,,,1,0,1,23,0.000011
Old Trolls Graveyard,,,3,23,26,41,0.000011
S4s/Board Newspapers,,,4,0,4,9,0.000032
Roflwaffle,,,2,10,12,9,0.000024
Ruth Frith,,,2,4,6,47,0.000024
Oldwindybear,,,2,11,13,2,0.000011
Olfactophilia,,,1,11,12,39,0.000011
Olinkalex,,,1,11,12,7,0.000011
Oliver,,,0,20,20,37,0.000011
Oliver Canby,,,1,20,21,46,0.000011
Oliver Keyes/wikipedia-en-2009-03-05,,,1,0,1,2,0.000013
Oliver Keyes/deleted Wikipedia article,,,1,1,2,4,0.000013
Oliver Keyes/wikipedia-en-2011-11-24,,,1,2,3,13,0.000012
Olivia,,,0,6,6,39,0.000011
Olivia Parson,,,2,20,22,26,0.000018
Category:ED Policy,,,4,0,4,2,0.000013
Olympics Gymnastics Fanfic,,,1,8,9,15,0.000012
Omegle/logs,,,1,2,3,53,0.000013
Omegle/logs2,,,1,0,1,18,0.000013
Omegle/logs3,,,1,0,1,18,0.000013
Omegle/logs4,,,1,0,1,18,0.000013
Omegle Auto Troller,,,2,3,5,18,0.000013
Omnetscient,,,1,18,19,8,0.000013
Omnipolitics16,,,1,13,14,53,0.000022
Omorashi-Fan,,,0,12,12,24,0.000011
On the Nature of Guerrilla Operations in a Metaverse Environment,,,1,13,14,31,0.000013
On wheels,,,0,4,4,2,0.000011
Onideus Mad Hatter/4th Space,,,1,8,9,49,0.000011
Onideus Mad Hatter/Facebook postings,,,1,6,7,52,0.000011
Onigojirakaiju/Fanfiction,,,1,24,25,34,0.000011
Onionland,,,1,11,12,10,0.000022
The Gentleman/logs,,,2,1,3,10,0.000013
Online Bingo,,,7,74,81,23,0.000013
Online Craps,,,6,31,37,23,0.000012
Sporcle,,,3,38,41,9,0.000014
Zing,,,2,11,13,60,0.000016
OoVoo,,,0,15,15,8,0.000011
Open Source Tea Party,,,2,2,4,10,0.000012
Open Water 2,,,1,10,11,44,0.000011
"Operation Vox Populi, Vox Dei",,,2,31,33,9,0.000011
Beef curtain,,,1,0,1,26,0.000011
Operation: LOLTreehouse,,,0,30,30,9,0.000011
Operation: Lights out,,,0,5,5,1,0.000011
Operation: Officer Pairs,,,0,11,11,59,0.000011
Operation: Stop Their Scheme,,,0,4,4,9,0.000011
Operation: Superbar,,,0,11,11,21,0.000011
Special Poetry Slam,,,7,15,22,9,0.000014
Operation LazarusTV,,,0,6,6,3,0.000011
Operation Pizzasplat,,,1,15,16,52,0.000014
Operation Shellshock,,,2,24,26,19,0.000013
Paula Benson Is Now A Meme,,,9,20,29,36,0.000031
Optimized Gif Dude,,,1,54,55,9,0.000011
Orain.org,,,3,10,13,2,0.000011
YIFF! The Musical,,,9,53,62,31,0.00002
Nationalism,,,1,0,1,14,0.000011
OrthodoxWiki,,,2,4,6,46,0.000013
Gaiz,,,1,0,1,40,0.000011
Sarah Saga,,,4,33,37,29,0.000012
Starprincess801,,,6,108,114,52,0.000013
Otherkin.com,,,4,44,48,31,0.000016
Otto Baxter,,,1,27,28,7,0.000044
Ottoid,,,1,11,12,12,0.000011
Ouija Board,,,0,18,18,35,0.000011
Ovamiat,,,1,21,22,31,0.000011
Overkill Software,,,1,15,16,17,0.000011
Overly Manly Man,,,0,1,1,9,0.000011
Desirable,,,1,0,1,2,0.000011
Warez-bb,,,2,79,81,10,0.000011
PCBIZNUSS,,,0,11,11,48,0.000011
PENIS PENIS PENIS,,,0,9,9,34,0.000011
Xspazztic,,,1,42,43,25,0.000012
PP,,,0,10,10,2,0.000011
The Chanology Experiments,,,6,66,72,26,0.000018
Rules of the Chanology,,,1,43,44,26,0.000017
PROJECT CHANOLOGY/CONTACT INFO,,,1,7,8,26,0.000011
PROJECT CHANOLOGY/CONTACT INFO/N AMERICA,,,1,1,2,26,0.000012
PROJECT CHANOLOGY/CONTACT INFO/S AMERICA,,,1,1,2,26,0.000012
PROJECT CHANOLOGY/CONTACT INFO/EUROPE,,,1,1,2,26,0.000012
PROJECT CHANOLOGY/CONTACT INFO/AFRICA,,,1,1,2,26,0.000012
PROJECT CHANOLOGY/CONTACT INFO/ASIA,,,1,1,2,26,0.000012
PROJECT CHANOLOGY/CONTACT INFO/OCEANIA,,,1,1,2,26,0.000012
PROJECT CHANOLOGY/Feb10 Media Archive,,,1,11,12,26,0.000015
PROJECT CHANOLOGY/IDES OF MARCH/AUSTRALASIA,,,1,6,7,26,0.000012
PROJECT CHANOLOGY/IDES OF MARCH/EUROPE,,,1,25,26,9,0.000012
PROJECT CHANOLOGY/IDES OF MARCH/EASTERN USA,,,3,5,8,26,0.000023
PROJECT CHANOLOGY/IDES OF MARCH/CENTRAL USA,,,1,3,4,26,0.000012
PROJECT CHANOLOGY/IDES OF MARCH/WESTERN USA,,,1,11,12,26,0.000012
PROJECT CHANOLOGY/IDES OF MARCH/CANADA,,,1,1,2,26,0.000012
PROJECT CHANOLOGY/IDES OF MARCH/MEDIA COVERAGE,,,3,11,14,26,0.000023
Scilon Basestar,,,1,6,7,26,0.000012
PROJECT CHANOLOGY/IRL PROTEST PAGE/PLANNING,,,5,18,23,26,0.000019
PROJECT CHANOLOGY/IRL PROTEST PAGE/EUROPE,,,5,11,16,1,0.000019
PROJECT CHANOLOGY/IRL PROTEST PAGE/EASTERN USA,,,5,13,18,26,0.000019
PROJECT CHANOLOGY/IRL PROTEST PAGE/CENTRAL USA,,,6,9,15,1,0.000019
PROJECT CHANOLOGY/IRL PROTEST PAGE/WESTERN USA,,,5,23,28,1,0.000019
PROJECT CHANOLOGY/IRL PROTEST PAGE/CANADA,,,5,6,11,1,0.000018
PROJECT CHANOLOGY/IRL PROTEST PAGE/IDES OF MARCH/General Guidelines,,,1,3,4,26,0.000012
PROJECT CHANOLOGY/IRL PROTEST PAGE/IDES OF MARCH/Inspirational Videos,,,1,3,4,26,0.000012
"PROJECT CHANOLOGY/IRL PROTEST PAGE/IDES OF MARCH/Houston, TX",,,1,4,5,9,0.000012
"PROJECT CHANOLOGY/IRL PROTEST PAGE/IDES OF MARCH/Los Angeles, CA",,,1,0,1,26,0.000012
PROJECT CHANOLOGY/IRL PROTEST PAGE/Phoenix/IDES OF MARCH OH EIGHT,,,2,68,70,26,0.000013
"PROJECT CHANOLOGY/IRL PROTEST PAGE/IDES OF MARCH/Portland, OR",,,1,1,2,26,0.000012
PROJECT CHANOLOGY/IRL PROTEST PAGE/IDES OF MARCH/StlouisMO,,,1,0,1,26,0.000012
PROJECT CHANOLOGY/IRL PROTEST PAGE/IDES OF MARCH/Vancouver,,,1,0,1,26,0.000012
PROJECT CHANOLOGY/IRL PROTEST PAGE/IDES OF MARCH/Dublin,,,1,0,1,26,0.000012
"PROJECT CHANOLOGY/IRL PROTEST PAGE/IDES OF MARCH/Belfast, County Antrim",,,1,0,1,26,0.000012
PROJECT CHANOLOGY/IRL PROTEST PAGE/Los Angeles,,,1,32,33,26,0.000012
PROJECT CHANOLOGY/IRL PROTEST PAGE/Operation Reconnect,,,2,9,11,26,0.000013
"PROJECT CHANOLOGY/IRL PROTEST PAGE/Operation Reconnect/Houston, TX",,,1,7,8,9,0.000012
PROJECT CHANOLOGY/IRL PROTEST PAGE/PLANNING/ARCHIVE FEB10,,,1,11,12,58,0.000012
PROJECT CHANOLOGY/Mission Directiva,,,1,0,1,26,0.000012
PROJECT CHANOLOGY/IRL PROTEST PAGE/Sacramento Raid,,,1,2,3,26,0.000012
PROJECT CHANOLOGY/IRL PROTEST PAGE/Phoenix,,,1,9,10,26,0.000012
PROJECT CHANOLOGY/IRL PROTEST PAGE/Phoenix/TWO TEN OH EIGHT,,,2,69,71,26,0.000012
PROJECT CHANOLOGY/IRL PROTEST PAGE/Phoenix/OPERATION RECONNECT,,,1,23,24,64,0.000012
File:Brawl.png,,,2,0,2,26,0.000011
PROJECT CHANOLOGY/OPERATION FAIRGAME:STOP,,,0,12,12,26,0.000011
PROJECT CHANOLOGY/OPERATION FAIRGAME:STOP/CANADA,,,0,3,3,9,0.000011
PROJECT CHANOLOGY/OPERATION FAIRGAME:STOP/WESTERN UNITED STATES,,,0,1,1,26,0.000011
PROJECT CHANOLOGY/OPERATION RECONNECT/AUSTRALASIA,,,1,0,1,26,0.000012
PROJECT CHANOLOGY/OPERATION RECONNECT/EUROPE,,,1,1,2,26,0.000012
PROJECT CHANOLOGY/OPERATION RECONNECT/EASTERN USA,,,1,1,2,26,0.000012
PROJECT CHANOLOGY/OPERATION RECONNECT/CENTRAL USA,,,1,1,2,26,0.000012
PROJECT CHANOLOGY/OPERATION RECONNECT/WESTERN USA,,,1,3,4,26,0.000012
PROJECT CHANOLOGY/OPERATION RECONNECT/CANADA,,,1,3,4,26,0.000012
PROJECT CHANOLOGY/OPERATION RECONNECT/MEDIA COVERAGE,,,3,0,3,26,0.000026
PROJECT CHANOLOGY/OPERATION SEA ARRRGH/AUSTRALASIA,,,1,0,1,26,0.000012
PROJECT CHANOLOGY/OPERATION SEA ARRRGH/EUROPE,,,1,20,21,26,0.000012
PROJECT CHANOLOGY/OPERATION SEA ARRRGH/EASTERN UNITED STATES,,,1,0,1,26,0.000012
PROJECT CHANOLOGY/OPERATION SEA ARRRGH/CENTRAL UNITED STATES,,,1,0,1,26,0.000012
PROJECT CHANOLOGY/OPERATION SEA ARRRGH/WESTERN UNITED STATES,,,1,1,2,26,0.000012
PROJECT CHANOLOGY/OPERATION SEA ARRRGH/CANADA,,,1,0,1,26,0.000012
PROJECT CHANOLOGY/LEAKED DOX,,,7,0,7,26,0.000014
Hygiene,,,1,0,1,39,0.000011
Weofodthignen,,,2,17,19,27,0.000013
Paganism:1,,,0,42,42,27,0.000011
Panteras,,,1,11,12,39,0.000011
Sharee,,,1,15,16,39,0.000011
Vampires Kiss0 aka God of Darkness0,,,3,14,17,12,0.000011
Cuveen,,,1,0,1,27,0.000011
Paheal/Userbase,,,4,176,180,64,0.000011
Franc,,,1,0,1,64,0.000011
Palalalapolly,,,3,12,15,41,0.000011
VCL Horrors,,,3,8,11,31,0.000012
Pannekoek,,,0,1,1,49,0.000011
Panther,,,0,4,4,35,0.000011
ParaCeleb,,,2,18,20,46,0.000011
Paradox Interactive,,,0,10,10,37,0.000011
Penguin,,,4,28,32,9,0.00002
PeerGuardian,,,2,23,25,10,0.000014
Paranoid Parrot,,,1,19,20,9,0.000011
Parasite Eve,,,1,23,24,49,0.000011
Sam Dashefsky,,,2,5,7,36,0.000014
Parodychan,,,1,4,5,9,0.000011
The Suckage,,,5,42,47,64,0.000035
SaviorChan,,,1,13,14,31,0.000013
Urizenus Sklar,,,2,19,21,31,0.000015
Windowlic Klaar,,,3,3,6,31,0.000013
Patriotic Nigras 2: Electric Boogoloo,,,0,9,9,31,0.000011
Patty Baber,,,1,18,19,26,0.000013
Space Opera,,,5,60,65,26,0.000018
Patty Mayo,,,0,5,5,19,0.000011
Paul Harvey,,,2,6,8,17,0.000012
Paul Shirley,,,4,10,14,41,0.000012
Paul Douglas Valentine,,,3,38,41,46,0.000014
Paul Watson,,,2,79,81,25,0.000013
Paul Nehlen,,,0,7,7,19,0.000011
Paula Goodspeed,,,2,30,32,36,0.000011
Crack babies,,,1,0,1,57,0.000011
Welfare checks,,,1,0,1,57,0.000011
Tartanclaymore,,,2,12,14,35,0.000011
Paulus,,,4,21,25,44,0.000011
Rottenraccoon,,,5,56,61,31,0.000017
Pay it Forward Weekend,,,0,5,5,54,0.000011
Peacockfeather,,,2,41,43,7,0.000011
Pedo Owen,,,1,15,16,9,0.000023
SectaChan,,,2,21,23,9,0.000012
Pedobear/favorites,,,1,17,18,18,0.000018
Peter Sotos,,,2,9,11,53,0.00002
Second Life/Logs,,,2,4,6,31,0.000025
Philip Anthony Thompson,,,2,17,19,53,0.000024
Sarah Butts/Nyberg Internet Defense Force,,,4,13,17,19,0.000018
Peep Show,,,1,21,22,26,0.000015
Peggy McIntosh,,,0,1,1,19,0.000011
Pekka-Eric Auvinen/archive,,,1,1,2,58,0.000012
Penis Pump Sex Scandal '06/Logs,,,2,3,5,41,0.000012
Penis Theft,,,1,1,2,63,0.000011
Richard Poplawski,,,3,28,31,26,0.000012
Pepe/Rare,,,1,8,9,19,0.000012
PeriodPearls,,,0,14,14,28,0.000011
Person of Interest,,,0,20,20,19,0.000011
Personal journal,,,1,3,4,41,0.000012
Personal space,,,2,17,19,13,0.000012
Pete Brand,,,1,18,19,46,0.000012
Peter Callan,,,3,66,69,12,0.000011
The Grifter,,,5,52,57,9,0.000014
Peter Pan Syndrome,,,0,9,9,7,0.000011
Scatological,,,1,0,1,17,0.000011
Phantom01987,,,0,1,1,21,0.000011
Uninteresting,,,1,0,1,34,0.000011
Phil,,,1,10,11,7,0.000011
Phil Elmore,,,2,33,35,23,0.000012
Philip,,,1,12,13,7,0.000012
Scissor,,,1,0,1,34,0.000011
Web hosts,,,1,0,1,10,0.000013
Phoebe Connop,,,0,17,17,58,0.000011
Phoenix Singer,,,1,8,9,19,0.000011
Phone posts,,,1,10,11,48,0.000011
Lucky225,,,1,0,1,10,0.000011
Pic Related Puppy,,,4,13,17,9,0.000016
Unrelated links,,,2,26,28,6,0.000018
Piedmont Park Hanging,,,0,29,29,35,0.000011
Yaeba,,,4,22,26,32,0.000016
Pikacat39,,,3,6,9,19,0.000011
Unfriend,,,1,0,1,49,0.000011
Pikmin Link,,,1,16,17,42,0.000011
Pinball Wizard,,,0,1,1,9,0.000011
Pingu,,,1,11,12,38,0.000012
PinkPrincessSunlight,,,0,53,53,7,0.000011
XxForeveredAloneXx,,,2,2,4,7,0.000011
Cyberbullied,,,1,0,1,7,0.000011
Pink Poodle,,,0,12,12,52,0.000011
Pink grill/This is nice X,,,3,10,13,9,0.000012
Wikipediametric,,,2,78,80,2,0.000012
Pirate3434,,,0,4,4,21,0.000011
Pirate Party,,,4,32,36,10,0.000011
Piratekiller,,,3,5,8,53,0.000012
Piss For Equality,,,1,6,7,41,0.000011
Pit Bulls,,,0,12,12,19,0.000011
William Freund,,,5,23,28,13,0.000016
Stick Arena,,,2,30,32,9,0.000011
StickPagePortal,,,3,8,11,63,0.000012
Pixel-paws,,,1,12,13,21,0.000011
Clit lickers,,,1,0,1,21,0.000011
PixelBeeProductions/Transcript,,,1,3,4,24,0.000012
WitnessX,,,3,3,6,41,0.000017
Val Kilmer,,,1,4,5,26,0.000012
Valkyrie,,,2,47,49,26,0.000012
Quest,,,1,0,1,31,0.000011
Planet Fitness,,,0,11,11,6,0.000011
Planetside 2,,,1,83,84,38,0.000011
Plastic Bag Challenge,,,0,3,3,53,0.000011
Platform Racing,,,1,120,121,32,0.000011
Landwhale,,,1,0,1,32,0.000011
Play Area,,,0,6,6,52,0.000011
ShadoWolffess,,,3,23,26,31,0.000013
Poetic Constellations,,,3,7,10,32,0.000014
Poetry.com,,,2,13,15,12,0.000013
PoisonIvyLul,,,3,34,37,19,0.000014
PokeDream,,,2,42,44,28,0.000011
PokeMMO,,,1,35,36,19,0.000011
Pokemaster7070,,,0,2,2,21,0.000011
Pokemon Mystery Dungeon Series,,,4,11,15,28,0.000015
Websense,,,1,37,38,10,0.000011
Filler,,,1,0,1,41,0.000011
"Pokédads, Poképarents or Pokésiblings",,,1,10,11,9,0.000011
Sophie Delezio,,,2,20,22,26,0.000014
Pokémon/Images,,,1,58,59,9,0.000013
Poképuns,,,3,10,13,9,0.000014
Pokémon/copypasta,,,0,2,2,5,0.000011
Politically Neutral Dog,,,1,1,2,2,0.000011
Politics Forum,,,1,38,39,21,0.000011
Pony Island,,,1,9,10,7,0.000011
Sonic . EXE,,,2,5,7,7,0.000013
Pyoko,,,2,46,48,49,0.000011
Pool's Closed/ASCII,,,2,1,3,9,0.00002
Ferreal,,,1,0,1,8,0.000011
X-Entertainment,,,2,13,15,10,0.000011
Waffles,,,1,4,5,32,0.000012
Popobawa,,,0,14,14,35,0.000011
Porch pirate,,,0,15,15,35,0.000011
Porn Wiki Leaks/Kristina Rose,,,0,3,3,0,0.000011
Porn Wiki Leaks/Mercedes Ashley,,,1,5,6,0,0.000011
Porn Wiki Leaks/Monica Foster,,,1,0,1,0,0.000013
Image iwg3q9q.jpg,,,1,0,1,0,0.000013
Image tx2kl94.jpg,,,1,0,1,0,0.000013
Image y7dig78.jpg,,,1,0,1,0,0.000013
Image nxqxlyt.jpg,,,1,0,1,0,0.000013
Porn Wiki Leaks/Sean Mathew Tompkins,,,1,12,13,0,0.000011
Portal:Anime/Featured Article,,,0,16,16,7,0.000011
Portal:Anime/Featured Article/Archive,,,0,67,67,28,0.000011
Portal:Anime/Notable Series,,,0,78,78,28,0.000011
Vampire Knight,,,1,42,43,7,0.000011
Portal:Anime/Related Articles,,,0,93,93,28,0.000011
Siscon,,,1,2,3,28,0.000011
SSO,,,3,24,27,64,0.000011
Y! Japanese Anime,,,2,118,120,52,0.000011
Portal:Anime/fatitle,,,0,1,1,28,0.000011
Portal:Animu/fatitle,,,0,1,1,28,0.000011
Portal:Anonymous/Chanology,,,0,88,88,26,0.000011
Stephan Hittmann,,,3,20,23,26,0.000011
Religious Freedom Watch,,,3,29,32,26,0.000011
STC,,,3,13,16,26,0.000011
You Found the Card,,,2,20,22,26,0.000011
Project Chanology/Scientology Front Groups,,,2,1,3,26,0.000011
Portal:Anonymous/Featured Article,,,0,15,15,2,0.000011
Portal:Anonymous/Featured Article/Archive,,,0,39,39,10,0.000011
Portal:Anonymous/Featured Media,,,0,1,1,9,0.000011
Portal:Anonymous/Featured Media/Archive,,,0,1,1,39,0.000011
Portal:Anonymous/Related Articles,,,0,55,55,26,0.000011
The Gentleman,,,2,18,20,10,0.000011
Portal:Anonymous/Welcome,,,0,1,1,26,0.000011
Portal:BNA,,,0,10,10,52,0.000011
The Chan Top List,,,2,21,23,9,0.000018
Portal:Chans/Chans List,,,0,55,55,9,0.000011
Rromchan,,,4,40,44,9,0.000014
Torchan,,,1,0,1,9,0.000011
Portal:Chans/Featured Article,,,0,10,10,9,0.000011
Portal:Chans/Featured Article/Archive,,,0,41,41,9,0.000011
Portal:Chans/Popular Boards,,,0,36,36,9,0.000011
Portal:Chans/Related Articles,,,0,186,186,9,0.000011
Ricky,,,3,22,25,9,0.00002
Prof. NohmNohmz,,,3,29,32,26,0.000011
Stile Raid,,,5,3,8,9,0.000011
Portal:Crime/Featured Article,,,0,1,1,58,0.000011
Portal:Crime/Related Articles,,,0,44,44,58,0.000011
Portal:DeviantART/Featured Media/Archive,,,0,4,4,21,0.000011
Portal:DeviantART/Needed,,,0,70,70,21,0.000011
Portal:DeviantART/Related Articles,,,0,563,563,21,0.000011
BadfurDay Takes Advantage Of A DA Exploit,,,4,0,4,41,0.000011
DA dAmn Exploit,,,3,0,3,41,0.000011
Miminka-mimi,,,1,0,1,21,0.000011
Princeshadow13,,,2,23,25,49,0.000011
Princessdimaond,,,2,19,21,7,0.000011
Proffate,,,2,45,47,31,0.000011
Raimyu,,,1,39,40,21,0.000011
Rememberance-the-fox,,,2,90,92,32,0.000011
RenegadeBuizel,,,2,59,61,21,0.000011
Reversed Pocky,,,3,61,64,41,0.000011
Reyvataeil,,,2,37,39,28,0.000019
Rhemora,,,1,45,46,21,0.000011
SableQueanVilaya,,,2,41,43,34,0.000011
Sandygurl,,,2,38,40,21,0.000016
SangheiliArtist,,,2,12,14,21,0.000011
SapphyDracases/Art,,,2,4,6,56,0.000011
SapphyDracases/Fanart,,,2,8,10,21,0.000011
SaxaFooey,,,3,68,71,21,0.000011
Sayuki-Kun,,,1,27,28,21,0.000011
Selucilia,,,2,9,11,36,0.000011
SephirothPrincess941/Cybersex Chat,,,4,16,20,24,0.000011
SesakaHeart,,,2,27,29,21,0.000011
SesshReincarnated,,,5,79,84,27,0.000013
Sevva-Phoenix,,,6,52,58,21,0.000011
SicMoP69,,,2,84,86,53,0.000011
SilenceGotttlos,,,2,14,16,21,0.000011
Skimlines,,,2,23,25,28,0.000011
SmilehKitteh,,,4,13,17,31,0.000011
Snapesnogger/Chat Lulz,,,2,8,10,21,0.000012
Snapesnogger/Comment Logs,,,2,66,68,21,0.000013
Snapesnogger/Deleted Journals,,,2,5,7,21,0.000012
Snapesnogger/Snapesnogger-Listen,,,2,5,7,5,0.000011
Snapesnogger/Trolling Archives,,,3,68,71,21,0.000012
Sonic X Bloopers,,,4,7,11,4,0.000013
SonicTeam765,,,1,29,30,49,0.000011
Spite170,,,2,35,37,21,0.000011
SpongeBobAndTheLoudHouseFanatic2012,,,2,18,20,34,0.000011
Squid-hater121,,,1,7,8,24,0.000011
Stardream1,,,2,13,15,28,0.000011
SuperSonicSkittles,,,1,19,20,7,0.000011
Suta-Raito Oekaki Advanced,,,3,19,22,24,0.000011
TamakiSpirit,,,1,16,17,38,0.000011
Tampon-Masturbation,,,2,23,25,50,0.000011
Tani-Da-Inki,,,4,27,31,36,0.000011
The League of Anti-Flamers,,,3,33,36,41,0.000011
TheDigifish,,,1,3,4,21,0.000011
TheFABNursery,,,2,21,23,21,0.000011
TheRealBumbleBee,,,2,35,37,19,0.000011
Tramp Graphics,,,2,57,59,34,0.000012
Tsukinohoshi,,,2,100,102,28,0.000011
TwoToneDearly,,,2,28,30,31,0.000011
TylerthDragon,,,2,19,21,7,0.000012
UltraGamma,,,3,36,39,21,0.000013
UnseelieAllure,,,2,34,36,18,0.000011
Voice-of-Blood,,,2,36,38,31,0.000011
Whitelinxanimator500,,,1,2,3,23,0.000011
Xbakkari,,,2,27,29,31,0.000011
Yerdian,,,1,39,40,19,0.000011
Yuethedragon/Journal,,,3,1,4,21,0.000011
Zeldalink76,,,1,39,40,21,0.000011
Portal:DeviantART/guide,,,0,8,8,21,0.000011
Portal:Faggotry,,,0,1,1,0,0.000011
Portal:Faggotry/Featured Article,,,0,17,17,40,0.000011
Portal:Faggotry/Featured Article/Archive,,,0,37,37,40,0.000011
Portal:Faggotry/Featured Media/Archive,,,0,1,1,40,0.000011
Portal:Faggotry/Related Articles,,,0,672,672,40,0.000011
Richard Littlejohn,,,4,25,29,37,0.000013
RobDoesTheInternet,,,4,66,70,40,0.000011
Rove McManus,,,2,35,37,40,0.000014
Scott DeiCas,,,6,19,25,48,0.000011
Se-chan,,,1,7,8,28,0.000011
Shake Weight,,,2,13,15,40,0.000012
SteAndKel,,,2,42,44,64,0.000011
Thefremen,,,3,39,42,39,0.000011
Thomas Donato,,,3,18,21,9,0.000023
Thoth,,,1,16,17,0,0.000011
White Paw,,,3,5,8,31,0.000011
World Wide Roleplay,,,3,53,56,4,0.000015
Xxstarfall,,,2,25,27,25,0.000011
Zoo Tycoon,,,4,47,51,31,0.000011
Portal:Faggotry/Welcome,,,0,1,1,0,0.000011
Portal:Furfaggotry/Articles,,,0,15,15,31,0.000011
Portal:Furfaggotry/Dead Furfags,,,0,6,6,31,0.000011
Portal:Furfaggotry/Featured Article,,,0,12,12,21,0.000011
Portal:Furfaggotry/Featured Article/Archive,,,0,61,61,31,0.000011
Portal:Furfaggotry/Featured Media/Videos/1,,,0,15,15,31,0.000011
Portal:Furfaggotry/Featured Media/Videos/2,,,0,18,18,31,0.000011
Portal:Furfaggotry/Featured Media/Videos/3,,,0,20,20,31,0.000011
Skroy,,,3,65,68,31,0.000011
Portal:Furfaggotry/Featured Media/Videos/4,,,0,1,1,7,0.000011
Portal:Furfaggotry/Furfags,,,0,514,514,31,0.000011
Primal War,,,2,12,14,35,0.000011
Psystra,,,3,62,65,63,0.000013
Puppetkun,,,2,37,39,31,0.000011
Rau,,,1,13,14,39,0.000011
Realalover,,,2,21,23,31,0.000011
REDDOG7,,,2,11,13,34,0.000013
Rexen,,,1,28,29,36,0.000011
RingTailedFox,,,2,23,25,31,0.000011
Rossthefox,,,4,35,39,41,0.000011
Samael,,,2,45,47,31,0.000011
Shadowfox,,,4,76,80,39,0.000011
Shadowpelt,,,1,27,28,31,0.000011
Silverop,,,1,41,42,31,0.000011
Sindragon,,,2,15,17,31,0.000011
Smokeyburr,,,1,33,34,34,0.000011
Sonadowclub,,,2,12,14,31,0.000011
SpexBlueFox,,,3,21,24,31,0.000016
Star Blade,,,3,13,16,31,0.000011
Stefanescu,,,1,8,9,5,0.000011
Tailfox,,,2,19,21,8,0.000011
TashkentFox,,,1,63,64,31,0.000011
Tigersclaw,,,1,15,16,31,0.000011
Timber22,,,2,7,9,1,0.000011
Ty the Fox,,,4,68,72,31,0.000018
Vox's Posse,,,5,112,117,21,0.000017
Wolfie,,,2,13,15,31,0.000011
Wolfmurr,,,2,28,30,31,0.000011
WONDERDAWG DINGO,,,1,35,36,31,0.000011
Wuffy78,,,1,2,3,31,0.000011
Yoko Beaumont,,,1,21,22,31,0.000011
Yoshi Art Forums,,,4,33,37,31,0.000013
Zakumi,,,2,21,23,31,0.000011
Zeal,,,5,16,21,41,0.000011
Zets coony,,,1,39,40,31,0.000011
Ziron,,,1,30,31,24,0.000011
Portal:Furfaggotry/Header,,,0,1,1,31,0.000011
Portal:Furfaggotry/Needed,,,0,37,37,31,0.000011
Portal:Furfaggotry/Related Articles,,,0,192,192,31,0.000011
Pound Puppies,,,1,23,24,34,0.000011
Sonic Forces,,,3,13,16,7,0.000012
The Great Meme Furbomination of 2010,,,2,37,39,31,0.000011
Portal:Furfaggotry/Shit,,,0,85,85,31,0.000011
Retarded icons,,,4,13,17,8,0.000011
Portal:Furfaggotry/Welcome,,,0,1,1,31,0.000011
Portal:Furfaggotry/dept,,,0,83,83,31,0.000011
Portal:Gaming/Featured Article,,,0,11,11,61,0.000011
Portal:Gaming/Featured Article/Archive,,,0,64,64,10,0.000011
Portal:Gaming/Featured Media/Archive,,,0,12,12,49,0.000011
Portal:Gaming/Games and Characters,,,0,422,422,49,0.000011
TV Tropes/Conquering The Queen,,,2,19,21,39,0.000011
TV Tropes/DoYouLikeHornyBunnies,,,2,3,5,2,0.000011
The Orion Project,,,1,65,66,49,0.000011
Preytor,,,1,21,22,18,0.000011
Rance,,,3,9,12,39,0.000012
Resident Evil Outbreak,,,7,43,50,49,0.000029
Rose and Camellia,,,1,17,18,32,0.000011
Serious Sam 3,,,1,51,52,13,0.000011
Shadowrun,,,2,26,28,49,0.000011
Shaq-Fu,,,2,62,64,49,0.000011
Sonic Robo Blast 2,,,1,86,87,7,0.000011
Sono Hanabira Ni Kuchizuke Wo,,,2,18,20,51,0.000011
Starhawk,,,1,10,11,49,0.000011
The Arkh Project,,,2,13,15,19,0.000011
The Sagara Family,,,2,12,14,36,0.000011
Tribes Ascend,,,2,21,23,49,0.000011
Visions,,,1,38,39,49,0.000011
Vortex,,,1,33,34,40,0.000011
Wurm Online,,,3,58,61,38,0.000012
X Change,,,3,26,29,22,0.000012
Xenimus,,,2,3,5,49,0.000011
ZeldaOnline,,,3,19,22,40,0.000011
Portal:Gaming/Related Articles,,,0,323,323,49,0.000011
Sega Game Gear,,,4,18,22,49,0.000014
Simply Okami,,,3,73,76,7,0.000011
Sythe,,,3,28,31,49,0.000014
Thenintendo3ds2,,,2,19,21,42,0.000011
The Online Gamer,,,3,61,64,49,0.000011
Steve Jackson Games,,,2,9,11,10,0.000011
RuneScape Forums,,,4,45,49,49,0.000014
Soraged,,,2,46,48,1,0.000011
TheGamerLand,,,3,11,14,40,0.000011
Spike's Video Game Awards,,,2,11,13,49,0.000013
StickyKeys,,,1,8,9,49,0.000011
The Wizard,,,5,26,31,49,0.000012
Portal:IRC,,,0,4,4,10,0.000011
Portal:IRC/ASCII Of The Now,,,0,2,2,10,0.000011
Portal:IRC/Featured Article,,,0,4,4,2,0.000011
Portal:IRC/Featured Article/Archive,,,0,28,28,41,0.000011
Portal:IRC/Related Articles,,,0,85,85,41,0.000011
Irssi/scripts/aol.pl,,,1,0,1,41,0.000011
Raspberryheaven,,,1,16,17,10,0.000011
Snugglenets/Nay Quits Irc Forever Again,,,2,0,2,41,0.000012
Portal:LiveJournal,,,0,1,1,8,0.000011
Portal:LiveJournal/Communities,,,0,52,52,8,0.000011
Six Degrees of Dramatization,,,1,9,10,7,0.000011
Wtf inc,,,2,27,29,8,0.000011
Wtf omgz,,,2,38,40,8,0.000011
Portal:LiveJournal/Featured Article,,,0,7,7,8,0.000011
Portal:LiveJournal/People,,,0,180,180,8,0.000011
Rissie,,,1,9,10,8,0.000011
Sanderella,,,2,2,4,8,0.000012
Scathachqme,,,1,6,7,8,0.000011
Smartypantsnyc,,,1,2,3,40,0.000011
Stiletto one,,,1,2,3,8,0.000011
WIZZY,,,1,7,8,8,0.000011
Xiota,,,1,13,14,8,0.000011
ZrA,,,2,10,12,63,0.000016
Portal:LiveJournal/Related Articles,,,0,40,40,8,0.000011
Virtual gift,,,2,15,17,8,0.000011
Rob's Law,,,2,5,7,8,0.000011
The LiveJournal Advisory Board Election,,,2,26,28,8,0.000011
Portal:LiveJournal/fc,,,0,1,1,8,0.000011
Portal:Media,,,0,1,1,34,0.000011
Portal:Memes/Featured Article,,,0,11,11,61,0.000011
Portal:Memes/Featured Article/Archive,,,0,36,36,9,0.000011
Portal:Memes/Featured Media/Archive,,,0,5,5,53,0.000011
Portal:Memes/Related Articles,,,0,1224,1224,9,0.000011
Actual Advice Mallard,,,1,0,1,9,0.000011
Advice Brah,,,1,0,1,9,0.000011
Advice Cardinal,,,1,0,1,9,0.000011
All The Niggers Are Dead,,,1,0,1,9,0.000011
Autobbl,,,1,0,1,9,0.000011
Bee Movie,,,3,0,3,34,0.000011
"ВИD",,,2,4,6,9,0.000014
CHARIOT OF THE GODS!,,,2,0,2,9,0.000011
Choice Tapir,,,1,0,1,9,0.000011
Creepy Sean,,,2,0,2,9,0.000011
FLOATERCAT,,,1,0,1,9,0.000011
Goron Proverbs,,,1,0,1,9,0.000011
Hi-Tech Military Software,,,2,0,2,9,0.000011
Lasercat,,,2,0,2,9,0.000011
Master Coon,,,1,0,1,9,0.000011
Random Hero,,,3,0,3,9,0.000045
Remorse Dog,,,1,2,3,12,0.000011
Renamon's Philosophy,,,1,7,8,31,0.000011
Russian PhotoExtreme,,,2,13,15,37,0.000011
Sex Ed Sue,,,1,2,3,50,0.000011
Shocked and Appalled Cat,,,4,39,43,9,0.000051
Shooby,,,4,16,20,35,0.000018
Shoopbill,,,2,16,18,9,0.000011
So cash/Translations,,,3,45,48,37,0.000011
Solidarity,,,3,6,9,14,0.000011
Spaghetti Cat,,,3,10,13,34,0.000011
Spaghetti in my Southbridge,,,2,7,9,9,0.000011
Spiderbro,,,4,13,17,9,0.000014
Spoiler Dog,,,1,0,1,9,0.000011
Steel Hearts,,,3,22,25,26,0.000011
Steve the Super Villian,,,4,3,7,9,0.000011
STOP THE PRESSES!,,,1,6,7,9,0.000011
Strange Girl,,,1,1,2,9,0.000011
Success Kid,,,2,12,14,9,0.000014
TAP LADEDANS FISTON!,,,2,4,6,9,0.000011
The Bawls Kid,,,3,13,16,9,0.000013
The Incredible Flying Broomstick Guy,,,4,26,30,36,0.000012
The Stig,,,5,17,22,9,0.000079
Tosh's Law,,,2,3,5,38,0.000011
Trollcats,,,2,23,25,34,0.000013
Unc drama coming up on Eyetoy,,,2,15,17,3,0.000011
Unfunny Gerrard,,,1,6,7,9,0.000011
Vicious Dog Man,,,2,10,12,59,0.000011
Vileplume,,,3,0,3,9,0.000011
Weebl,,,2,21,23,44,0.000011
What 4chan crys out during sex,,,4,6,10,9,0.000011
Where do you want to go today?,,,1,5,6,10,0.000011
When You're Chill With Everyone,,,1,2,3,40,0.000011
Women do not their shower,,,2,15,17,9,0.000011
Wooden table,,,2,10,12,9,0.000011
Woom,,,3,11,14,9,0.000011
World AIDS Day Raid,,,3,1,4,9,0.000012
X people Y,,,3,28,31,32,0.000011
You Are Ban,,,3,4,7,9,0.000011
You Know Frog,,,2,9,11,9,0.000011
Your a fucking idiot,,,5,31,36,9,0.000025
Youth Mentor Bear,,,1,5,6,53,0.000011
Portal:Memes/Welcome,,,0,1,1,9,0.000011
Portal:Memes/bna,,,0,3,3,9,0.000011
Portal:Memes/firstbreakdown,,,0,300,300,9,0.000011
Portal:Memes/gna,,,0,4,4,9,0.000011
Portal:Memes/old,,,0,3,3,9,0.000011
Portal:Memes/secondbreakdown,,,0,709,709,9,0.000011
Portal:Music/Featured Article,,,0,6,6,12,0.000011
Portal:Music/Featured Article/Archive,,,0,27,27,12,0.000011
Portal:Music/Featured Media/Archive,,,0,1,1,58,0.000011
Portal:Music/People,,,0,151,151,12,0.000011
"Royce da 5'9""",,,1,31,32,35,0.000011
The Naked Brothers Band,,,1,19,20,12,0.000011
Pyrobooby,,,2,37,39,61,0.000011
Segacamp,,,2,43,45,48,0.000011
Portal:Music/Related Articles,,,0,167,167,12,0.000011
Umcrs,,,2,28,30,15,0.000011
PureVolume,,,2,13,15,12,0.000011
Portal:Music/bna,,,0,6,6,12,0.000011
Portal:Music/fv,,,0,1,1,42,0.000011
Portal:Music/gna,,,0,8,8,12,0.000011
Portal:Politics/Featured Article,,,0,7,7,14,0.000011
Portal:Politics/Featured Article/Archive,,,0,57,57,19,0.000011
Portal:Politics/Related Articles,,,0,238,238,14,0.000011
Thomas Paine,,,3,94,97,37,0.000012
Roy West,,,1,18,19,35,0.000011
Wunderground,,,2,19,21,15,0.000011
Portal:Sex,,,0,5,5,50,0.000011
Portal:Sex/Featured Article,,,0,17,17,40,0.000011
Portal:Sex/Featured Article/Archive,,,0,39,39,40,0.000011
Walls Fall Out,,,3,8,11,39,0.000011
Portal:Sex/Featured Media/Archive,,,0,7,7,28,0.000011
Portal:Sex/Related Articles,,,0,503,503,39,0.000011
Prince Willy,,,3,6,9,27,0.000011
SensationBot,,,4,12,16,39,0.00003
Sinn,,,5,36,41,52,0.000011
Squirtage Wiki,,,4,14,18,2,0.000014
Susie Q's Party Game,,,4,40,44,39,0.000015
TGP Porn Sites,,,3,14,17,39,0.000029
Vaginatarian,,,3,10,13,39,0.000011
War porn,,,2,18,20,39,0.000011
Wetlook,,,4,10,14,39,0.000011
Wikiporno,,,3,29,32,2,0.000011
Xxxchurch,,,4,23,27,18,0.000011
Portal:Sex/basic,,,0,25,25,36,0.000011
Portal:Sex/ff,,,0,67,67,31,0.000011
Portal:Sex/people,,,0,385,385,39,0.000011
Portal:Sites/Featured Article,,,0,12,12,59,0.000011
Portal:Sites/Featured Article/Archive,,,0,31,31,59,0.000011
Portal:Sites/Related Articles,,,0,1038,1038,6,0.000011
Newgrounds/Header,,,1,0,1,6,0.000011
PotterForums,,,2,40,42,41,0.000011
Psyke.org,,,4,15,19,12,0.000018
Pyromaniac Guy,,,6,13,19,6,0.000015
R.O.A.C.H.,,,3,29,32,31,0.000011
Rave Match,,,2,11,13,50,0.000012
Ravelry,,,1,15,16,6,0.000011
ReligionIsFree.org,,,1,12,13,5,0.000011
Respectance.com,,,3,49,52,11,0.000011
Sensible Erection,,,3,80,83,1,0.000012
Shadowland.org,,,2,20,22,31,0.000015
Shockingtube,,,2,7,9,53,0.000012
Shodan,,,1,4,5,10,0.000011
Sickipedia,,,1,45,46,1,0.000011
Slashcode,,,2,10,12,10,0.000013
Slightly Insane Graphics,,,2,28,30,0,0.000011
Sonic Blast,,,1,0,1,6,0.000011
Soulja Boy Tellem Chat,,,4,29,33,12,0.000012
Stardestroyer.net,,,2,15,17,17,0.000013
Stormchan,,,3,11,14,9,0.000012
StumbleUpYours,,,2,14,16,10,0.000012
Swagbucks,,,1,10,11,17,0.000011
TFS The Floods Sanctuary,,,1,9,10,49,0.000011
TG Comics,,,3,41,44,63,0.000012
TV.com,,,4,55,59,8,0.000025
Teen Mania Ministries,,,2,82,84,46,0.000011
Tektek,,,1,17,18,11,0.000011
The Anti-Twilight Movement,,,7,28,35,32,0.000014
The Legend of Razor,,,2,8,10,28,0.000012
The Pirate Bay/thepiratebay.se proxy list,,,1,1,2,6,0.000011
The Velvet Vulva,,,2,27,29,39,0.000036
TheClubBKids,,,1,39,40,9,0.000011
ThisAintNews.com,,,2,14,16,10,0.000011
Threadless.com,,,1,13,14,12,0.000011
Topix,,,2,14,16,17,0.000014
Totalt ointressant information,,,1,9,10,36,0.000011
Tribe.net,,,3,9,12,12,0.000015
Tymb,,,2,27,29,35,0.000011
Underground Forum,,,2,47,49,40,0.000012
Uranium Ore,,,2,16,18,34,0.000014
Vampireposers.com,,,3,13,16,12,0.000013
Vandalize.us,,,1,14,15,2,0.000011
Vaughn Live,,,1,4,5,6,0.000011
Wikiality,,,9,22,31,2,0.000017
WishUponAHero,,,2,6,8,41,0.000011
World Wide Chat,,,2,1,3,20,0.00002
Xat/How-to,,,2,0,2,24,0.000011
Yugioh Card Maker,,,4,90,94,50,0.000012
Zeitgeist Movement,,,6,15,21,26,0.000017
Portal:Social Justice/Featured Article,,,0,3,3,19,0.000011
Portal:Social Justice/Featured Article/Archive,,,0,30,30,19,0.000011
Portal:Social Justice/Featured Media,,,0,1,1,39,0.000011
Portal:Social Justice/Featured Media/Archive,,,0,4,4,39,0.000011
Portal:Social Justice/Related Articles,,,0,256,256,19,0.000011
Sisterofsilence,,,1,19,20,19,0.000011
T.J. Miller,,,1,10,11,19,0.000011
Jian Ghomeshi,,,1,0,1,19,0.000011
We Don't Say,,,1,9,10,19,0.000011
Portal:Social Media,,,0,1,1,19,0.000011
Portal:Social Media/Featured Article,,,0,12,12,59,0.000011
Portal:Social Media/Featured Article/Archive,,,0,35,35,59,0.000011
Portal:Social Media/Related Articles,,,0,92,92,59,0.000011
Ash Hilton,,,2,0,2,59,0.000011
Slanegirl,,,1,29,30,14,0.000011
Portal:Softwarez/Archive,,,0,3,3,10,0.000011
Portal:Softwarez/Featured Article,,,0,8,8,10,0.000011
Portal:Softwarez/Featured Article/Archive,,,0,15,15,10,0.000011
Portal:Softwarez/Featured Media/Archive,,,0,3,3,52,0.000011
Portal:Softwarez/ap,,,0,23,23,10,0.000011
Portal:Softwarez/languages,,,0,14,14,10,0.000011
Portal:Softwarez/people,,,0,12,12,10,0.000011
Portal:Television/Featured Article,,,0,11,11,34,0.000011
Portal:Television/Featured Article/Archive,,,0,82,82,34,0.000011
Portal:Television/Featured Media/Archive,,,0,4,4,34,0.000011
Portal:Television/Related Articles,,,0,304,304,34,0.000011
The Grim Adventures of Billy & Mandy,,,1,67,68,38,0.000011
Air Bud,,,1,0,1,34,0.000011
The Mission,,,1,3,4,50,0.000011
Wendy Burch,,,1,0,1,34,0.000011
Take the meat bridge,,,2,27,29,34,0.000011
Portal:Trolls/A-Z,,,0,302,302,41,0.000011
Richard Bullis,,,5,25,30,41,0.000014
Tabris Macbeth,,,3,32,35,41,0.000011
Targ,,,3,39,42,30,0.000011
Terry Childs,,,4,1,5,41,0.000014
Trolls on fire,,,2,32,34,41,0.000011
Trollwars,,,5,11,16,41,0.000013
Xpeacheznlemonx,,,3,8,11,1,0.000011
Portal:Trolls/Depts,,,0,34,34,10,0.000011
Portal:Trolls/Featured Article,,,0,17,17,19,0.000011
Portal:Trolls/Featured Article/Archive,,,0,73,73,19,0.000011
Portal:Trolls/Featured Media/Archive,,,0,2,2,37,0.000011
Portal:Trolls/Related Articles,,,0,1159,1159,41,0.000011
R9gay/Raid,,,3,1,4,25,0.000013
RS10 Gang,,,2,12,14,49,0.000012
Scam Emails,,,2,3,5,53,0.000011
Sharisasweetie,,,2,14,16,41,0.000011
Silverfuck,,,2,18,20,41,0.000011
Smarterchild,,,2,21,23,17,0.000011
Snooty sims,,,3,8,11,41,0.000011
Sonic Fanon Wiki,,,2,13,15,2,0.000011
Spacehero/JS,,,2,1,3,41,0.000012
SpectateSwamp,,,2,12,14,41,0.000011
Staedtler,,,3,7,10,41,0.000013
Steve Ostrowski,,,3,41,44,46,0.000011
Steven F Lott,,,4,19,23,41,0.000012
StolenSidekick,,,3,33,36,35,0.000013
Suojeluskunta.com,,,1,7,8,26,0.000011
The Amazing Racist,,,1,20,21,35,0.000011
The Great Habbo Raid of July 2006/LOL,,,2,1,3,9,0.000012
The Untrolled,,,1,0,1,41,0.000011
TheSuperRobotSoujaOG,,,4,50,54,32,0.000011
T-Mobile Hack,,,3,2,5,10,0.000013
Trevor's Axiom,,,1,7,8,41,0.000011
Victoria Alexander,,,3,24,27,21,0.000013
Weekly slayings,,,2,5,7,41,0.000011
West Memphis Three,,,1,25,26,12,0.000011
Wikistress,,,3,7,10,2,0.000012
Wtprn,,,3,4,7,41,0.000019
YouTube Anti-Troll Club,,,2,48,50,15,0.000011
YouTube Subscriber Hack,,,2,23,25,48,0.000011
Zyce,,,1,28,29,10,0.000011
Portal:Trolls/Selected Article,,,0,1,1,37,0.000011
Portal:Trolls/bna,,,0,13,13,41,0.000011
Portal:Trolls/fa,,,0,14,14,7,0.000011
Portal:Trolls/firstbreakdown,,,0,364,364,41,0.000011
Youflood,,,3,2,5,48,0.000011
YouTube Avatars,,,2,8,10,41,0.000011
Portal:Trolls/gna,,,0,11,11,41,0.000011
Portal:Trolls/newsbox,,,0,3,3,1,0.000011
Portal:Trolls/secondbreakdown,,,0,389,389,41,0.000011
Portal:Truth/Featured Article,,,0,2,2,17,0.000011
Portal:Truth/Featured Article/Archive,,,0,58,58,17,0.000011
Portal:Truth/Featured Media/Archive,,,0,8,8,17,0.000011
Portal:Truth/Related Articles,,,0,267,267,46,0.000011
"‎Edward Snowden",,,1,0,1,46,0.000011
The Satanic Verses of Bhagavad-gita,,,2,12,14,37,0.000012
VenomFangX/Criticism,,,3,24,27,46,0.000012
VenomFangX/Online Drama,,,3,111,114,48,0.000012
Wikipedia's censored guide to nitroglycerin,,,4,7,11,58,0.000012
Portal:Truth/archive,,,0,16,16,17,0.000011
Portal:Truth/bna,,,0,5,5,26,0.000011
Portal:Truth/gna,,,0,4,4,17,0.000011
Portal:Truth/rumors,,,0,10,10,17,0.000011
Portal:Truth/truthbox,,,0,220,220,46,0.000011
Portal:Truth/welcome,,,0,1,1,49,0.000011
Portal:Whores,,,0,1,1,2,0.000011
Portal:Whores/Featured Article,,,0,26,26,19,0.000011
Portal:Whores/Featured Article/Archive,,,0,78,78,19,0.000011
Portal:Whores/Related Articles,,,0,421,421,36,0.000011
Codenamesailorearth/2nd Wikia Saga/Blacklist,,,2,0,2,36,0.000011
Rehtaeh Parsons,,,1,32,33,36,0.000011
"Stage, Renee Nicole",,,2,57,59,36,0.000015
Rima Fakih,,,1,17,18,37,0.000011
Rottensick,,,1,13,14,36,0.000011
Slinx,,,2,1,3,41,0.000012
Stephanie Semple,,,1,31,32,36,0.000011
Stephh Fkn Money,,,3,15,18,12,0.000012
Taylor Chapman,,,2,11,13,8,0.000012
Vilde,,,1,13,14,36,0.000011
Portal:Wikipedia/BNA,,,0,5,5,2,0.000011
Portal:Wikipedia/Featured Article,,,0,3,3,17,0.000011
Yank Barry,,,4,8,12,17,0.000016
Portal:Wikipedia/Featured Article/Archive,,,0,1,1,2,0.000011
Portal:Wikipedia/GNA,,,0,5,5,2,0.000011
Portal:Wikipedia/QOTN,,,0,2,2,52,0.000011
Portal:Wikipedia/Related Articles,,,0,90,90,2,0.000011
Surgipedia,,,2,17,19,2,0.000011
Wikipedia/Jokes,,,1,15,16,2,0.000011
Proposed deletion,,,2,21,23,2,0.000011
Portal:Wikipedia/WOTN,,,0,4,4,2,0.000011
Portal:Wikipedia/Wikipedos,,,0,151,151,2,0.000011
Silsor,,,2,6,8,2,0.000012
Jweiss11,,,1,0,1,2,0.000011
Wim Crusio,,,2,8,10,2,0.000012
Safwwefe,,,1,4,5,2,0.000011
ST47,,,1,17,18,2,0.000011
Portal:Wikipedia/topstuff,,,0,1,1,2,0.000011
Portal:Wikis/Dep,,,0,53,53,2,0.000011
Portal:Wikis/WOTN,,,0,9,9,2,0.000011
Portal:YouTube,,,0,4,4,48,0.000011
Portal:YouTube/Featured Article,,,0,3,3,19,0.000011
Portal:YouTube/Featured Article/Archive,,,0,90,90,49,0.000011
Portal:YouTube/Related Articles,,,0,863,863,48,0.000011
Proper Words Song,,,1,5,6,53,0.000011
RebelTaxi,,,6,38,44,34,0.000013
Redlenses2112,,,1,31,32,32,0.000011
Red Minus,,,2,27,29,1,0.000011
Robtran,,,2,20,22,48,0.000015
Rooster Teeth,,,1,25,26,49,0.000011
Sanjaya/J,,,2,1,3,29,0.000011
ScottHermanFitness,,,1,29,30,40,0.000011
SKWEEZY,,,1,14,15,35,0.000011
Sleepykinq,,,2,9,11,37,0.000015
Tay Zonday/CRLyrics,,,2,1,3,48,0.000014
Techa,,,5,13,18,48,0.000012
Terror Playlist,,,2,22,24,37,0.000016
Thdrkside,,,1,37,38,24,0.000011
The Failkips Strikes Back,,,2,112,114,5,0.000011
The Slow Mo Guys,,,2,25,27,49,0.000011
The Spoony Experiment/Spoony and Friends,,,2,84,86,61,0.000011
TheMidnightLycanroc225,,,1,7,8,7,0.000011
Timmygal,,,1,22,23,46,0.000011
TolstoyKafkaEvsky,,,1,41,42,15,0.000011
Unstrappd,,,1,102,103,40,0.000011
Unsubscribing,,,1,13,14,19,0.000011
VaLLarrr,,,1,27,28,26,0.000011
Vennu Mallesh,,,1,23,24,12,0.000011
Verdmidious Reznov,,,1,11,12,7,0.000011
VideoGameDunkey,,,1,3,4,19,0.000011
Vipor231/YouTube,,,2,4,6,48,0.000013
Virtual Youtubers,,,1,71,72,28,0.000011
Wolfeedarkfang/videos,,,2,103,105,32,0.000011
Xatu,,,1,13,14,28,0.000011
YouNoober,,,2,10,12,48,0.000011
YouTube Ratings,,,2,4,6,61,0.000011
YouTube War Expert,,,2,9,11,37,0.000013
Young Tubers United/The Trades Article,,,3,17,20,48,0.000012
Zzz33333,,,1,19,20,48,0.000011
Portal:deviantART/Featured Article,,,0,1,1,7,0.000011
Portal:deviantART/Featured Article/Archive,,,0,65,65,21,0.000011
Portal:deviantART/Welcome,,,0,1,1,21,0.000011
WinterRose,,,1,23,24,30,0.000011
Posse,,,0,4,4,33,0.000011
Post Malone,,,0,8,8,20,0.000011
Post Trump Stress Disorder,,,0,3,3,19,0.000011
Pottering,,,1,3,4,36,0.000011
PrayFor,,,0,5,5,58,0.000011
Preachertom,,,1,9,10,40,0.000011
Prep the Bull,,,0,14,14,37,0.000011
PedoTalk,,,1,0,1,47,0.000012
Cool Kids,,,1,0,1,47,0.000012
Prime Minister,,,1,13,14,14,0.000015
Prince Jeremy/Chat logs,,,1,3,4,5,0.000011
Princess Doll,,,0,12,12,28,0.000011
Freeleech,,,1,0,1,10,0.000011
Sansgras,,,1,10,11,8,0.000016
Professor,,,1,10,11,2,0.000015
Project Chanology/Anonymous Directory,,,1,1,2,65,0.000011
Project Chanology/Operation FairGame:Stop,,,0,12,12,26,0.000011
Project Freeweb/Media,,,3,1,4,26,0.000012
Project Freeweb/Propaganda,,,3,0,3,26,0.000012
Project Freeweb/Adelaide,,,1,0,1,26,0.000011
Project Freeweb/Protest Planning,,,0,26,26,26,0.000011
Project Freeweb/Resource Center,,,0,10,10,26,0.000011
Project Utopia,,,0,40,40,26,0.000011
There are no women on the internet,,,1,0,1,26,0.000011
Ancient aliens,,,1,0,1,26,0.000011
Prokofy Neva/Batshittery,,,1,1,2,49,0.000011
Prolexic,,,1,3,4,10,0.000015
Abomination,,,1,0,1,14,0.000012
Final form,,,1,0,1,49,0.000011
Mold,,,1,0,1,39,0.000011
Satyr,,,1,73,74,37,0.000011
Modern technology,,,1,0,1,26,0.000013
Psystra/Chatlog,,,1,4,5,59,0.000011
Pulse Faggot,,,1,0,1,58,0.000012
Pumkin World,,,0,27,27,4,0.000011
Pusheen,,,1,4,5,25,0.000011
Androgyny,,,1,0,1,31,0.000011
Pussyhawk/English,,,1,19,20,40,0.000012
PyeongChang 2018 Winter Olympics,,,0,6,6,47,0.000011
Lgbt/,,,1,0,1,9,0.000012
Cunt punt,,,1,0,1,31,0.000011
Queen's Stallion,,,0,16,16,31,0.000011
Queeny Martha,,,1,8,9,52,0.000011
Queer Kid Stuff,,,0,22,22,37,0.000011
Quentin,,,0,3,3,26,0.000011
Windows Media Player,,,4,16,20,10,0.000023
R000t/r000tlogs,,,1,0,1,10,0.000011
RFJason CL Experiment/Replies,,,1,0,1,41,0.000012
ROFL BROTHEL,,,1,12,13,48,0.000018
RPU,,,0,26,26,28,0.000011
Friends page,,,2,0,2,41,0.000013
Rabbit Proof Fence,,,0,3,3,23,0.000011
Lucky,,,1,0,1,35,0.000011
Racefan2464,,,0,3,3,15,0.000011
Rachel,,,0,10,10,35,0.000011
Rachel Stieringer,,,1,20,21,13,0.000012
Wikichan/Rachel,,,2,5,7,9,0.000015
Rachel Marsden/Jimbo Wales deleted statement,,,1,1,2,2,0.000014
Racistsgettingfired,,,0,35,35,0,0.000011
Rade Subotic,,,0,3,3,59,0.000011
Salmon,,,1,19,20,28,0.000011
The Great Metrowyn Raids of 2010,,,1,25,26,26,0.000013
RainFurrest,,,0,25,25,31,0.000011
Randi Harper/Mobile/,,,0,101,101,52,0.000011
Randy,,,0,7,7,58,0.000011
Randy Robert Stair/Early Years,,,1,0,1,58,0.000011
Randy Robert Stair/01 Information,,,1,0,1,58,0.000011
Randy Robert Stair/acc,,,1,0,1,58,0.000011
Rantic Marketing,,,0,25,25,19,0.000011
The Wannabe Dickriders,,,3,17,20,58,0.000012
Raproll,,,2,15,17,9,0.000017
Rapefugee/Scrap,,,0,25,25,37,0.000011
Un popular,,,1,0,1,8,0.000013
Original copy,,,1,0,1,8,0.000013
Ews,,,1,0,1,19,0.000011
Raukue/Quotes,,,1,1,2,31,0.000011
Raulo Cáceres,,,0,20,20,22,0.000011
Raven Williams,,,1,20,21,27,0.000032
Ravenswood,,,1,9,10,35,0.000014
RawPunk,,,0,3,3,40,0.000011
Ray,,,0,8,8,46,0.000011
Ray Tensing,,,2,10,12,35,0.000012
Ray Jones/fanfic,,,1,1,2,31,0.000012
Raymond Garcia,,,1,103,104,24,0.000011
Raynfall,,,0,6,6,19,0.000011
Rayyan Sokkarie,,,0,26,26,37,0.000011
Re-Reg,,,1,9,10,18,0.000014
ReZ,,,2,10,12,9,0.000017
Realitysquared/Chat logs,,,1,7,8,21,0.000011
Brickhousebunny21,,,1,0,1,19,0.000011
Rebecca Sugar,,,2,22,24,17,0.000011
Obvious shit,,,1,0,1,19,0.000011
Recep Tayyip Erdoğan,,,1,22,23,37,0.000012
RedLetterMedia/GIF's,,,1,0,1,61,0.000012
RedPanels,,,0,8,8,19,0.000011
Redd Foxx,,,0,33,33,35,0.000011
Article title,,,1,0,1,2,0.000012
Redlenses2112/Skype Chat Fail,,,1,2,3,32,0.000011
Refath0,,,0,38,38,49,0.000011
Regular Ordinary Swedish Meal Time,,,0,8,8,37,0.000011
Regular Show/Episode Guide,,,1,17,18,40,0.000011
Reiko,,,2,29,31,19,0.000023
Ren Fest,,,1,13,14,10,0.000011
Shit hole,,,1,0,1,51,0.000012
Yosemite sam,,,1,0,1,40,0.000015
Replay398,,,0,21,21,64,0.000011
Sue Scheff,,,3,54,57,11,0.000011
Restimulation,,,2,15,17,26,0.000019
Retard/Autism Raid,,,1,1,2,5,0.000044
Reviewbrah,,,0,2,2,20,0.000011
Rex Fowler,,,0,22,22,26,0.000011
Saga kid,,,1,0,1,51,0.000011
Taa,,,1,0,1,51,0.000011
Richard,,,0,20,20,15,0.000011
Richard Jeni,,,2,21,23,61,0.000011
Richard Stallman/chatlogs,,,1,0,1,10,0.000012
Rick,,,1,12,13,14,0.000011
Rick Falkvinge,,,1,5,6,10,0.000012
Rick and Morty/Episode Guide,,,1,66,67,4,0.000011
The Rolling : MTV Gets Rickroll'd,,,1,123,124,26,0.000014
Right Wing Death Squad Entertainment,,,0,9,9,19,0.000011
RileyAV,,,1,5,6,28,0.000011
Rina-Chan/KJ Communist laws,,,1,59,60,35,0.000011
RipRoarRex,,,0,2,2,37,0.000011
Ripper/BeforeOD,,,1,12,13,1,0.000016
Ripper/PostOD,,,2,4,6,1,0.000018
Irchighway,,,1,0,1,41,0.000012
Robert A. Howard,,,2,11,13,26,0.000012
Robert Morrow,,,1,5,6,35,0.000011
Trichophilia,,,2,17,19,63,0.000011
Robert Casio/Someguy827 vs casio,,,1,0,1,22,0.000011
Freedom of speech bitchez. Murka fuck yeh.png,,,1,0,1,35,0.000013
Excuse,,,1,0,1,53,0.000012
"Robert Wayne Stiles/""Original Story""",,,1,17,18,7,0.000011
Roblox/Copypasta,,,0,1,1,48,0.000011
Robots . txt,,,1,3,4,2,0.000012
Rocket Science,,,0,1,1,28,0.000011
Rocklin Gutbelly,,,0,17,17,9,0.000011
Rod Wheeler,,,0,9,9,35,0.000011
Rome: Total War,,,0,32,32,37,0.000011
Ronald,,,0,15,15,14,0.000011
Rootbeerkegger,,,1,6,7,41,0.000012
Command prompt,,,1,0,1,48,0.000011
Power-bottom,,,1,0,1,48,0.000011
Rootbrian/Twitter,,,1,2,3,48,0.000011
Roselite,,,0,3,3,36,0.000011
Rtfm,,,1,8,9,9,0.000011
Fission mailed,,,1,0,1,28,0.000011
Ruby Dragon Entertainment/Hungarian,,,1,113,114,29,0.000011
Ruby Gloom,,,0,18,18,21,0.000011
RuneScape Private Servers,,,1,16,17,49,0.000013
Homeschool,,,1,0,1,14,0.000012
Russia-love,,,0,2,2,51,0.000011
The War of 1812,,,2,129,131,37,0.000014
UVB-76,,,1,3,4,5,0.000011
Unbaleeted,,,1,0,1,33,0.000011
Ryan733,,,1,28,29,49,0.000015
Ryan733/logs,,,1,2,3,49,0.000011
Ryan (fleshlight),,,1,9,10,26,0.000011
Ryan Hawe,,,0,50,50,39,0.000011
Nigger dicks,,,1,0,1,39,0.000011
Ryan Kopf,,,0,22,22,36,0.000011
Ryulong/Wikiabuse article,,,1,3,4,2,0.000011
SF-productions,,,0,5,5,21,0.000011
Thewillpower,,,2,2,4,6,0.000014
SQL Injection/How To,,,1,3,4,10,0.000014
STFW,,,0,7,7,3,0.000011
SUBTLE HINT ALERT::,,,0,4,4,8,0.000011
"Sabu/Dear Brother ""Leader"" Of Lulzsec",,,1,0,1,10,0.000013
Sacconejolys,,,0,1,1,48,0.000011
Sacred Wolf,,,1,41,42,29,0.000011
Cba,,,1,0,1,29,0.000011
Tyrant,,,1,0,1,37,0.000013
Saddie Julian,,,1,24,25,32,0.000014
SadisticScorpio420,,,0,9,9,7,0.000011
Cheat code,,,1,0,1,39,0.000015
Human toilet,,,1,0,1,37,0.000011
Thedestructor,,,2,15,17,8,0.000014
Sam Blacketer/TOW,,,1,0,1,2,0.000012
Capeshit,,,1,0,1,19,0.000012
Stylometry,,,1,138,139,10,0.000015
Samuel,,,0,18,18,19,0.000011
Sanctuary Cities,,,0,9,9,19,0.000011
ICE,,,1,0,1,19,0.000012
Sunnis,,,1,0,1,14,0.000011
Sandbox/top,,,0,2,2,2,0.000011
Sandra Negron,,,0,22,22,36,0.000011
Sanguinarious,,,0,12,12,10,0.000011
Sanguinarius,,,1,19,20,27,0.000012
Uncyclopedia/Chat logs,,,2,1,3,2,0.000018
SapphyDracases/Copypasta,,,1,6,7,28,0.000011
SapphyDracases/Screencaps,,,1,7,8,28,0.000011
Sarah,,,0,10,10,29,0.000011
Sarah Butts/DMCA,,,1,0,1,19,0.000011
Sargon Quest/Punch Wife,,,4,2,6,19,0.000085
Sargon Quest/Eat,,,2,2,4,19,0.000066
Sargon Quest/Make YouTube,,,5,3,8,19,0.000126
Sargon Quest/Cry On Twitter,,,3,3,6,19,0.000087
Sargon Quest/Livestream,,,1,4,5,19,0.000035
Sargon Quest/Masturbate,,,2,3,5,19,0.000043
Sargon Quest/Time to Sleep,,,3,1,4,19,0.000066
Sasha Wiley-Shaw,,,0,23,23,42,0.000011
Interesting,,,1,0,1,46,0.000016
Satanhatesyu,,,1,19,20,12,0.000016
Temple of the Vampire,,,4,4,8,27,0.000019
Ratatata,,,1,0,1,36,0.000011
Schroedinger's Cunt,,,2,2,4,42,0.000012
Train surfing,,,1,5,6,58,0.000012
School Shooter: North American Tour 2012,,,0,32,32,58,0.000011
Schoolitdown22,,,0,21,21,15,0.000011
Steins;Gate,,,1,46,47,28,0.000017
PROJECT CHANOLOGY/IRL PROTEST PAGE/Chicago,,,1,0,1,26,0.000015
PROJECT CHANOLOGY/IRL PROTEST PAGE/Orlando,,,1,0,1,26,0.000015
Scorpion,,,1,3,4,25,0.000012
Scott Allen Meek Stephens,,,0,30,30,35,0.000011
Smug Wendy's,,,1,11,12,41,0.000011
Scott Pruitt,,,0,9,9,6,0.000011
Scott Rosenfeld,,,0,24,24,7,0.000011
Scotty24360/cg club,,,1,0,1,53,0.000011
Scotty24360/causing drama,,,1,0,1,53,0.000011
Scotty24360/suicide guilt trip,,,1,0,1,53,0.000011
Scotty24360/scotty vs flexay,,,1,0,1,53,0.000011
Scotty24360/batshit crazy 1,,,1,0,1,53,0.000011
Scotty24360/english lesson,,,1,0,1,53,0.000011
Scotty24360/gtfo my land,,,1,0,1,53,0.000011
Scotty24360/banned from amh,,,1,0,1,53,0.000011
Scotty24360/calling ISP,,,1,0,1,53,0.000011
Scotty24360/failtroll,,,1,0,1,53,0.000011
Scotty24360/moredrama,,,1,0,1,53,0.000011
Scotty24360/meetme2,,,1,0,1,53,0.000011
Scotty24360/reacting to hacking,,,1,0,1,53,0.000011
Scotty24360/convo with hana,,,1,0,1,53,0.000011
Scotty24360/malice guilt trip,,,1,0,1,53,0.000011
Scotty24360/nice guy drama,,,1,0,1,53,0.000011
Scrambles,,,0,6,6,48,0.000011
Scrap.tf,,,1,1,2,31,0.000013
Screensaver,,,1,10,11,10,0.000013
Scuba,,,0,5,5,25,0.000011
Scunthorpe Conundrum,,,0,7,7,41,0.000011
Sean (711chan),,,1,16,17,9,0.000011
Sean Kelly,,,1,0,1,9,0.000011
Seapunk,,,0,3,3,12,0.000011
Second American Civil War,,,0,16,16,19,0.000011
Sedwicks,,,0,6,6,18,0.000011
Seediq Bale,,,0,14,14,39,0.000011
Selena Lechuga,,,0,117,117,19,0.000011
Self-Victimization,,,1,57,58,19,0.000011
Sep7agon,,,0,11,11,11,0.000011
Planet,,,1,0,1,46,0.000011
Sergio Pelico,,,1,13,14,58,0.000011
Tha w3rm,,,1,18,19,8,0.000014
Seto-Kaiba.com/IRC,,,1,1,2,53,0.000011
SevenSuperGirls,,,1,3,4,53,0.000011
Shadow-IRC/Chat logs,,,0,1,1,2,0.000011
Internet relationships,,,1,0,1,31,0.000011
Boyfriends,,,1,0,1,56,0.000011
Hyooman,,,1,0,1,56,0.000011
Shanadrac,,,0,36,36,6,0.000011
Shane,,,0,4,4,26,0.000011
Shane Halligan,,,1,13,14,58,0.000013
Shanley Kane/My Statement,,,1,0,1,39,0.000011
Victim loop,,,3,5,8,1,0.000012
Shannon Watts,,,0,14,14,58,0.000011
Rapage,,,1,0,1,9,0.000011
Wonchop,,,2,17,19,21,0.000013
Supersonic Muffin,,,1,11,12,31,0.000013
Shelly Dankert,,,0,6,6,14,0.000011
Sheneequa Turns Four,,,1,31,32,48,0.000017
Sherri Shepherd,,,1,14,15,46,0.000015
Shtick,,,1,0,1,50,0.000011
Dual,,,1,0,1,28,0.000011
Shironeko,,,0,8,8,28,0.000011
Shock44,,,0,5,5,22,0.000011
The Satiratician,,,1,5,6,19,0.000011
Goddess of the internet,,,1,0,1,43,0.000012
Shy Boys IRL,,,0,12,12,7,0.000011
Silencer Cat,,,0,4,4,25,0.000011
Silly Dan,,,2,24,26,2,0.000012
StarNeptune,,,4,18,22,2,0.000012
Silver seren/Our Time Together,,,1,0,1,2,0.000011
Silver seren/Cursed Beginnings,,,1,0,1,2,0.000011
Silver seren/Aftershocks,,,1,0,1,2,0.000011
Silver seren/Friends No More,,,1,0,1,2,0.000011
Silver seren/War of Loss,,,1,0,1,2,0.000011
Silver seren/Derek's Past - Part 1,,,1,0,1,2,0.000011
Silver seren/Derek's Past - Part 2,,,1,0,1,2,0.000011
Silver seren/Derek's Past - Part 3,,,1,0,1,2,0.000011
Silver seren/The Host - A Fan Fiction,,,1,0,1,2,0.000011
Silver seren/CotM - A Twilight Fanfiction,,,1,0,1,2,0.000011
Silver seren/Friendships,,,1,0,1,2,0.000011
Silver seren/For A Crush,,,1,0,1,2,0.000011
"Silver seren/Burn, Fire, Burn",,,2,0,2,2,0.000011
Silver seren/YiffyLeaks,,,1,0,1,2,0.000011
Anti-feminist,,,1,0,1,39,0.000012
Simon,,,0,8,8,29,0.000011
Simon And Garfunkel,,,1,0,1,29,0.000012
Simon Ng,,,2,16,18,11,0.000013
Simpson,,,0,4,4,34,0.000011
Fanatics,,,1,0,1,46,0.000011
Anal-oral sex,,,1,0,1,46,0.000011
Razor blade,,,1,0,1,46,0.000011
Sindy Pop,,,0,31,31,28,0.000011
Siroh32,,,0,4,4,53,0.000011
SissyHayden,,,0,24,24,7,0.000011
Site Feedback,,,0,1,1,15,0.000011
Teamnoir,,,1,0,1,7,0.000012
Testing your Wiki skillz,,,2,12,14,2,0.000025
Skorksis Avro,,,0,1,1,31,0.000011
Popufur,,,1,0,1,31,0.000011
Skuee/logs,,,1,0,1,48,0.000011
Boards,,,1,0,1,10,0.000013
Will Hill,,,1,6,7,63,0.000012
Slaton Sisters,,,0,6,6,4,0.000011
Not a bug,,,1,0,1,37,0.000011
Smithy Boy and Crew,,,0,10,10,12,0.000011
Superpeeps101,,,1,15,16,21,0.000011
Smushiie,,,0,23,23,24,0.000011
Snapesnogger/Paintchat log,,,1,2,3,0,0.000012
Sniko,,,0,9,9,9,0.000011
Snitch (person),,,1,28,29,41,0.000016
Snoregasm,,,0,3,3,57,0.000011
Snuggie,,,0,14,14,19,0.000011
Olev,,,1,0,1,9,0.000013
Social Deviancy,,,0,5,5,7,0.000011
Social Repose,,,0,11,11,19,0.000011
Stat,,,1,0,1,13,0.000011
Sodomite Suppression Act,,,0,15,15,40,0.000011
Software Crack,,,1,23,24,10,0.000018
Sokal affair,,,0,16,16,16,0.000011
SokiTwopaw/logs,,,1,3,4,10,0.000011
SolanumLycopersicum,,,0,2,2,39,0.000011
Venus (disambiguation),,,1,4,5,63,0.000011
SolidMario/Videos,,,1,0,1,7,0.000011
Piggyback,,,1,0,1,30,0.000011
Wikipedia Review/DL,,,2,0,2,2,0.000012
SonicTheHedgehog988,,,0,11,11,7,0.000011
Two Babies One Fox,,,1,16,17,22,0.000012
Sonmanic/IMs,,,1,1,2,3,0.000011
Sophie Elise Isachsen,,,0,31,31,19,0.000011
Souls Series,,,0,6,6,49,0.000011
South Park/Episode Guide,,,1,0,1,34,0.000012
Telus,,,1,2,3,37,0.000016
Space Station 13,,,0,15,15,32,0.000011
Zebra,,,1,0,1,24,0.000012
Waterdogs,,,1,7,8,31,0.000012
Spastic Virgin Auction,,,1,5,6,38,0.00002
Spax3/Spax and the Law,,,1,48,49,48,0.000013
SpexBlueFox/logs,,,1,2,3,1,0.000011
Spider's Web: A Pig's Tale,,,1,23,24,34,0.000011
SpizzTrizz,,,0,22,22,7,0.000011
Angery,,,1,0,1,34,0.000013
SpongeGar,,,1,4,5,34,0.000013
Wumbo,,,1,3,4,34,0.000013
Spongebobvstheloudhouse,,,0,16,16,34,0.000011
Springs1,,,1,28,29,52,0.000012
Squishy Squashy,,,0,16,16,19,0.000011
Dilaudid,,,1,0,1,35,0.000011
Stan,,,0,19,19,37,0.000011
Standing Cat,,,0,4,4,48,0.000011
Stanley Thornton,,,0,14,14,0,0.000011
StarForce,,,1,8,9,37,0.000015
Harmless,,,1,0,1,37,0.000012
Star Ocean: Till the End of Time,,,0,51,51,32,0.000011
Star Wars: Battlefront II,,,0,20,20,49,0.000011
Starbound,,,0,38,38,49,0.000011
Starkiller88/Conversations,,,0,11,11,2,0.000011
Template:Articleexhibits,,,2,0,2,27,0.000016
Starless,,,0,30,30,36,0.000011
Starter Kit,,,0,2,2,58,0.000011
Steam/Games,,,1,65,66,49,0.000013
Rape victim,,,1,0,1,31,0.000011
Steam friend thread,,,0,7,7,49,0.000011
Wikichan/Roommate from Hell,,,1,0,1,28,0.000011
Stephen Fowler,,,0,7,7,18,0.000011
Stephen Huff,,,0,23,23,1,0.000011
Steven Joseph,,,1,8,9,12,0.000011
Shitcock,,,1,0,1,46,0.000011
Steve Silberman,,,0,4,4,7,0.000011
Steven Universe/Episode Guide,,,1,92,93,34,0.000011
Steven Universe/Characters,,,0,86,86,28,0.000011
Wonk,,,2,3,5,3,0.000021
Money footage,,,1,0,1,48,0.000012
Intervention,,,1,0,1,48,0.000012
Std's,,,1,0,1,48,0.000012
Tiny balloon dick,,,1,0,1,48,0.000012
Shitlist,,,1,0,1,48,0.000012
Internet ego machine,,,1,0,1,35,0.000011
Imporant,,,1,0,1,35,0.000011
Stormy Daniels,,,0,21,21,19,0.000011
Straight White Boys,,,1,29,30,12,0.000014
Street Skolla,,,0,1,1,35,0.000011
Crack rocks,,,1,0,1,35,0.000011
StrikeGently.com,,,0,46,46,9,0.000011
Strwbrri shrtck,,,1,6,7,8,0.000015
Stubbs the mayorcat,,,0,25,25,25,0.000011
The children in Africa,,,1,0,1,14,0.000011
"‎Doopie DoOver",,,1,0,1,24,0.000029
Tender Crisp Bacon Cheddar Ranch,,,1,17,18,41,0.000012
Ebaums did it,,,1,0,1,26,0.000012
Sue Basko/You Know The Trees,,,1,0,1,10,0.000011
Sue Basko/5 Victims,,,0,2,2,52,0.000011
Sue Basko/LA Times autism comments,,,0,1,1,35,0.000011
Sueboo,,,0,50,50,52,0.000011
Sulejman Talovic,,,0,11,11,58,0.000011
Superlisamcb/Language,,,1,2,3,37,0.000011
Supermaryface,,,0,6,6,7,0.000011
Supersprite65,,,0,19,19,7,0.000011
The name of the page,,,1,13,14,2,0.000011
Suzi Olsen,,,0,35,35,24,0.000011
Shakesphere,,,1,0,1,12,0.000011
Sweetie,,,0,18,18,37,0.000011
SweetyDanger,,,0,33,33,41,0.000011
SwordTheYellowKirby,,,0,23,23,64,0.000011
Sylvia,,,0,3,3,42,0.000011
Synthia-China Blast,,,0,5,5,39,0.000011
TFO IS A BELLEND,,,0,1,1,60,0.000011
TGWTG/GuruLarry,,,1,12,13,61,0.000012
Ocular rape,,,1,0,1,63,0.000011
TGcomix/Emails,,,1,0,1,32,0.000011
"THE NEW HOVEROUND TESTAMENT, BOOK OF CADNOCAT",,,0,7,7,48,0.000011
"THE NEW HOVEROUND TESTAMENT, BOOK OF CADNOCAT/CadnoCops Down Under",,,1,1,2,48,0.000012
"THE NEW HOVEROUND TESTAMENT, BOOK OF CADNOCAT/CadnoCat Counters",,,1,0,1,48,0.000012
"THE NEW HOVEROUND TESTAMENT, BOOK OF CADNOCAT/Saga of the Deet",,,1,1,2,48,0.000012
TIME,,,0,11,11,61,0.000011
TL;DR/Titin,,,0,1,1,5,0.000011
TMTOWTDI,,,1,6,7,10,0.000012
YMMV,,,3,12,15,15,0.000018
TROLLS F**CKING SUCK,,,0,6,6,5,0.000011
TTYL,,,0,1,1,8,0.000011
TV Tropes/Deleted Encyclopedia Dramatica Article,,,1,2,3,32,0.000012
TV Tropes/Deleted This Troper Article,,,1,5,6,61,0.000012
TV Tropes/NAUGHTY TENTACLES,,,2,4,6,2,0.000012
TV Tropes/AkiSora,,,1,2,3,23,0.000011
TV Tropes/Hen,,,1,1,2,0,0.000011
TV Tropes/HogwartsExposed,,,1,2,3,2,0.000012
TV Tropes/Horrible FanficsE-H,,,6,6,12,2,0.000037
TV Tropes/Horrible FanficsI-L,,,6,6,12,2,0.000037
TV Tropes/Horrible FanficsM-P,,,6,6,12,2,0.000037
TV Tropes/Horrible FanficsQ-T,,,6,7,13,2,0.000038
TV Tropes/Horrible FanficsU-Z,,,6,6,12,2,0.000037
The Girl Who Lived,,,1,2,3,2,0.000012
TWITsci,,,1,5,6,41,0.000015
Tablecow/Arbchat,,,1,0,1,7,0.000011
Tablecow/Logs,,,1,1,2,32,0.000011
Encyclopedia Dramatica:How 2 EDit for Dummies,,,1,0,1,41,0.000011
Tammy McArdle,,,0,14,14,46,0.000011
Snakesnogger,,,1,0,1,50,0.000011
Tangent,,,0,5,5,41,0.000011
Mental,,,1,0,1,36,0.000011
Impprtant,,,1,0,1,7,0.000011
Suck up,,,1,0,1,7,0.000011
Tarisai Vushe,,,0,18,18,8,0.000011
Tarshana,,,0,19,19,49,0.000011
Childbirth,,,1,0,1,35,0.000011
Tay Allyn,,,0,1,1,61,0.000011
Taylor,,,0,6,6,4,0.000011
TeamBerserk,,,0,7,7,26,0.000011
Strike team,,,1,0,1,26,0.000012
Troll group,,,1,0,1,26,0.000012
YTPMV,,,1,5,6,34,0.000013
Team Fortress 2/Major Updates,,,0,101,101,32,0.000011
Double anal,,,1,0,1,12,0.000017
Ted,,,0,11,11,39,0.000011
Teen Titans and Teen Titans Go!,,,0,4,4,34,0.000011
Teenage Kings of Werribee/Dr Porto,,,1,1,2,39,0.000012
TehBigToaster/A Chat With Tomoe Chan,,,1,2,3,48,0.000011
TehPerfectoArmy,,,0,27,27,31,0.000011
Temidite,,,0,45,45,7,0.000011
Themysticenigma,,,1,89,90,7,0.000011
Tempraphobia,,,0,12,12,18,0.000011
Tennis,,,1,3,4,63,0.000011
Terrence,,,0,11,11,43,0.000011
Sir Bearington,,,1,0,1,9,0.000011
The Rapping Dog,,,1,9,10,61,0.000012
That Guy With The Glasses/Blistered Thumbs,,,1,149,150,61,0.000011
That Guy With The Glasses/movies,,,0,58,58,61,0.000011
The-Sakura-Samurai,,,0,13,13,38,0.000011
TheAmazingAtheist/AmandaToddSuicide,,,0,10,10,58,0.000011
TheAmazingAtheist/FreeSpeechVids,,,0,3,3,48,0.000011
TheAmazingAtheist/HisWork,,,0,40,40,46,0.000011
TheAmazingAtheist/JoiningTGWTG,,,0,6,6,61,0.000011
TheAmazingAtheist/Publicity,,,0,1,1,53,0.000011
TheAmazingAtheist/ThatFatAtheist,,,0,18,18,13,0.000011
TheAmazingAtheist/VersusED,,,0,4,4,47,0.000011
TheBrainEnema,,,0,27,27,61,0.000011
TheDOSFag/Gallery,,,1,56,57,9,0.000011
TheDOSFag/Archive,,,0,24,24,57,0.000011
TheFatJewish,,,0,14,14,17,0.000011
Wrgh,,,1,0,1,40,0.000012
TheGrapist,,,0,13,13,7,0.000011
ThePirateCoveMan,,,0,22,22,13,0.000011
ThePornDude,,,0,11,11,18,0.000011
TheSyndicateProject,,,0,20,20,51,0.000011
TheTopTens,,,0,38,38,38,0.000011
TheVeganStudent,,,0,8,8,7,0.000011
The Academy Awards,,,0,169,169,19,0.000011
The Adventures Of Jimmy Neutron: Boy Genius,,,0,66,66,34,0.000011
The Arguecat Challenge,,,1,3,4,52,0.000013
Lynch mob,,,1,0,1,41,0.000012
The Articles of Lulz,,,0,21,21,3,0.000011
The Best Korean War,,,1,30,31,37,0.000011
WW,,,3,4,7,37,0.000013
Foreskin wallet,,,1,0,1,35,0.000011
The Comprehensive Guide to Becoming a Bro,,,0,16,16,35,0.000011
The Cowardly Christian,,,0,7,7,53,0.000011
Ten bux,,,1,0,1,36,0.000011
The Day My Butt Went Psycho!,,,0,7,7,22,0.000011
The Dragon Doctors,,,1,11,12,15,0.000012
The Fear,,,0,4,4,34,0.000011
The First Plague: Fire,,,0,5,5,48,0.000011
The Great /r/osugame Defence,,,0,7,7,50,0.000011
The Great Meme War/Infobox,,,0,41,41,19,0.000011
The Great Paint Conspiracy of 1945,,,0,3,3,37,0.000011
Cook,,,1,0,1,32,0.000011
The Greek Semen,,,0,9,9,50,0.000011
The Hart Family,,,0,27,27,35,0.000011
The Hatred Starts,,,0,2,2,13,0.000011
The Holders/Holders of the end,,,1,0,1,5,0.000011
Aggron,,,1,0,1,34,0.000011
The Mandela Effect,,,0,1,1,17,0.000011
The Merchant of Venice,,,0,8,8,17,0.000011
Baby daddy,,,1,0,1,42,0.000011
The Promised Land/Lulzvasion,,,1,12,13,48,0.000014
The Real Chris-chan/The Singstar Challenge,,,0,7,7,24,0.000011
The Right Stuff,,,0,9,9,19,0.000011
Fat girl,,,1,0,1,26,0.000011
The Side Quest Gamer,,,0,7,7,37,0.000011
The Skeptic Feminist,,,1,5,6,46,0.000011
Restraining order,,,1,0,1,44,0.000011
The Thaw,,,0,16,16,46,0.000011
Lipstick lesbian,,,1,0,1,39,0.000012
The Who,,,0,15,15,0,0.000011
Thekosher,,,1,0,1,2,0.000011
WHO AM ARTICLE?,,,1,0,1,2,0.000011
Cipherspace,,,1,0,1,9,0.000011
Doyouatecat,,,1,0,1,8,0.000011
Falling out,,,1,0,1,10,0.000012
Coflower,,,1,0,1,8,0.000012
Zhzhblyad,,,1,0,1,8,0.000012
Sinderella7,,,1,0,1,8,0.000012
Thesugarmonster/Surgery,,,1,9,10,52,0.000011
Thgtrolleater,,,0,14,14,19,0.000011
Thiopental Sodium,,,0,14,14,39,0.000011
Thirst,,,0,3,3,46,0.000011
Raymond B. Bailey,,,1,0,1,10,0.000012
Those Pesky Dames,,,0,3,3,17,0.000011
Thumb,,,0,2,2,29,0.000011
Was,,,1,0,1,31,0.000011
Tigga Please,,,0,3,3,19,0.000011
Tim,,,0,20,20,43,0.000011
Titty Grab,,,0,3,3,3,0.000011
"To, Too, and Two",,,0,16,16,3,0.000011
To Aru Majutsu no Index,,,0,95,95,28,0.000011
Toby J Rathjen/Trolls,,,1,10,11,7,0.000012
Todd,,,0,15,15,19,0.000011
Tommy Parky,,,1,3,4,12,0.000011
Tom Preston/German,,,2,61,63,28,0.000012
"טום פרסטון",,,1,53,54,28,0.000011
War Machine,,,3,23,26,19,0.000014
Tomservo3,,,0,18,18,4,0.000011
Tonygreen,,,0,12,12,38,0.000011
Toontown Rewritten,,,1,25,26,31,0.000011
Bootlegged,,,1,0,1,31,0.000011
Abrahamtard,,,1,0,1,17,0.000013
Torba,,,0,60,60,19,0.000011
Toresbe,,,1,37,38,36,0.000011
Ethnic,,,1,0,1,35,0.000011
Tr1p,,,2,0,2,4,0.000012
Wikivoyage,,,3,57,60,2,0.000014
Traffic Controller,,,0,8,8,59,0.000011
Travis Runkel,,,0,34,34,35,0.000011
Troll harder,,,3,9,12,9,0.000041
Zeriara/ImageGalleries2,,,6,17,23,21,0.000016
Zeriara/ImageGalleries3,,,6,9,15,21,0.000015
Trolley Rulle,,,0,22,22,58,0.000011
Dataminer,,,1,0,1,32,0.000011
Troy,,,0,4,4,3,0.000011
Troy King,,,1,5,6,40,0.000013
Trumpwave,,,1,4,5,19,0.000013
Truthiracy,,,0,20,20,17,0.000011
Is,,,1,0,1,28,0.000011
Agoraphobic,,,1,0,1,12,0.000011
Turner,,,0,3,3,26,0.000011
Lohere,,,1,0,1,9,0.000011
Skanky,,,1,0,1,36,0.000013
Vampires Suck,,,1,17,18,38,0.000013
Sense,,,1,0,1,32,0.000011
Viperhor,,,1,0,1,32,0.000011
Two Worlds,,,1,76,77,8,0.00002
Two Worlds/Arbchat,,,1,0,1,8,0.000011
Two Worlds/chat,,,1,1,2,8,0.000011
Ty (disambiguation),,,1,5,6,43,0.000011
Ty the Fox/Chat Logs,,,1,0,1,31,0.000011
Tycho Brahe,,,1,11,12,1,0.000019
Tyler Lumar,,,0,35,35,35,0.000011
Typhon/Chat log,,,1,3,4,31,0.000011
Typhoon Cinema,,,0,5,5,49,0.000011
Boob shot,,,1,0,1,18,0.000011
Tyra Patterson,,,0,18,18,35,0.000011
Excited,,,1,0,1,10,0.000011
Uckfield,,,0,8,8,14,0.000011
UkieKooki,,,0,25,25,12,0.000011
Wikichan/A Moral Dilemma,,,1,0,1,37,0.000011
Ulf Larsen,,,0,10,10,2,0.000011
Leet pvp,,,1,0,1,49,0.000011
Ultima Online/UOGamers: Demise,,,0,35,35,34,0.000011
Ultima Online/UOGamers: Hybrid,,,0,46,46,1,0.000011
Example,,,1,0,1,24,0.000011
Live video,,,1,0,1,48,0.000011
Uriel,,,0,4,4,23,0.000011
VIDEO OF THE MAO,,,0,2,2,48,0.000011
Reg,,,1,0,1,12,0.000011
VampiricSpektor/chatlog1,,,2,2,4,27,0.000035
VampiricSpektor/chatlog2,,,3,2,5,27,0.000056
VampiricSpektor/chatlog3,,,2,1,3,27,0.000035
Vampiricspektor/SkypeLogs,,,1,1,2,27,0.000011
Vermin/Autobiography,,,1,3,4,52,0.000013
Vermin/Autobiography/Fixed,,,1,1,2,52,0.000014
Very Melon,,,1,2,3,34,0.000014
Victoria King,,,0,17,17,36,0.000011
Video Game High School,,,0,34,34,49,0.000011
Car crash,,,1,0,1,49,0.000013
Dioxin,,,1,0,1,37,0.000012
Violet Blue/logs,,,1,17,18,2,0.000011
Vipor231/Youtube,,,0,4,4,48,0.000011
Vladimir Zhirinovsky,,,0,6,6,0,0.000011
Self-hatred,,,1,0,1,2,0.000011
Vordrak/Emails,,,1,2,3,19,0.000011
Vordrak/What People Have To Say,,,1,0,1,19,0.000011
Soldier,,,1,0,1,40,0.000011
W-Hat,,,0,9,9,31,0.000011
W. T. Snacks/How the Snacks Stole Christmas,,,1,32,33,9,0.000015
W. T. Snacks/Firing Logs,,,1,0,1,9,0.000015
WMV,,,2,3,5,10,0.000022
WP:DNLAED,,,0,10,10,2,0.000011
WP:You have no rights,,,0,2,2,2,0.000011
Wtp,,,1,20,21,57,0.000048
Dark age,,,1,0,1,46,0.000011
Wall Smath,,,1,57,58,14,0.000011
Category:Series,,,1,0,1,16,0.000011
Warbears/SLWalkthrough,,,1,11,12,41,0.000011
Warbears/Logs5,,,1,3,4,16,0.000011
Warbears/Logs1,,,1,1,2,16,0.000011
Warbears/Log4,,,1,3,4,16,0.000011
Warbears/SSLogs1,,,1,3,4,16,0.000011
Warbears/SSLogs2,,,1,3,4,16,0.000011
Warbears/SSLogs3,,,1,3,4,16,0.000011
Warbears/SSLogs4,,,1,3,4,16,0.000011
Warbears/Logs2,,,1,1,2,16,0.000011
Warbears/Logs3,,,1,3,4,16,0.000011
Warcommander,,,0,19,19,17,0.000011
Washington (disambiguation),,,1,8,9,37,0.000011
Web of Trust,,,0,16,16,10,0.000011
The general public,,,1,0,1,7,0.000011
Weev/Lyrics,,,1,3,4,41,0.000014
Weev quotes,,,1,1,2,41,0.000014
Weev: Still Here,,,0,54,54,41,0.000011
Weevs Oppressive Page,,,1,6,7,41,0.000014
Menstrual clots,,,1,0,1,27,0.000011
Werdna/Chat logs,,,1,1,2,41,0.000011
Wesley,,,0,5,5,27,0.000011
Wetflame/Logs,,,2,1,3,5,0.000011
Wetflame/oldrevs,,,0,29,29,5,0.000011
Stupid cows,,,1,0,1,25,0.000011
What-EVER,,,0,5,5,8,0.000011
Opsec,,,1,0,1,10,0.000012
What.cd/transcripts,,,1,0,1,10,0.000012
Catch phrase,,,1,0,1,8,0.000013
WhiteFire,,,0,21,21,31,0.000011
WhiteMystery/QuitsIRCForever,,,1,0,1,2,0.000011
Face lift,,,1,0,1,36,0.000032
Drown,,,1,0,1,27,0.000012
Wikichan/Insult my Wii,,,1,0,1,49,0.000012
Wiigii!,,,0,17,17,34,0.000011
Grope,,,1,0,1,19,0.000012
Stare,,,1,0,1,19,0.000012
WikiShitizens,,,0,44,44,2,0.000011
THIS IS INCEST,,,1,0,1,9,0.000024
Wikichan/Across the Board,,,0,1,1,9,0.000011
Wikichan/Almost Raep,,,0,1,1,39,0.000011
Wikichan/An eight-year-old cum slut,,,0,4,4,28,0.000011
Wikichan/Anonymous's Damaged Goods Dream,,,0,2,2,53,0.000011
Wikichan/Fukiya Siking,,,0,1,1,9,0.000011
Wikichan/Incest-chan,,,0,3,3,9,0.000011
Wikichan/Itoko Otoko,,,0,4,4,9,0.000011
Wikichan/Loving sister,,,0,1,1,9,0.000011
Wikichan/Mixed Signals,,,0,5,5,32,0.000011
Wikichan/TT-Kun,,,2,3,5,16,0.000063
Wikichan/Turned Tables,,,1,1,2,16,0.000028
Wikichan/Weirdest Bitch Ever,,,0,1,1,66,0.000011
"Wikichan/ITT, we discuss the crazies we have met in our lifetime.",,,1,0,1,66,0.00002
Wikimedia Commons view stats,,,1,1,2,2,0.000015
Wikipe-tan/Think,,,1,2,3,28,0.000011
ED vs TOW,,,1,0,1,2,0.000019
Wikipedia's Greatest Hits Sex,,,2,16,18,2,0.00002
Wikipedia's Greatest Hits,,,1,9,10,2,0.000012
Wikipedia's Greatest Hits Diseases,,,1,2,3,2,0.000012
Wikipedia's Greatest Hits Body Modification,,,2,0,2,2,0.000017
Wikipedia's Greatest Hits Oddities,,,2,2,4,2,0.000012
Wikipedia's Greatest Hits Lists,,,1,1,2,2,0.000012
Wikipedia Review/I'm researching Encyclopedia Dramatica,,,0,2,2,2,0.000011
Www.yahoo.com,,,1,0,1,63,0.000012
Daniel Brandt/Wikipedia,,,1,0,1,2,0.000012
Wikipediametric/Radeksz,,,1,0,1,2,0.000011
Wikipediametric/Cabal tactics,,,1,2,3,63,0.000011
Wikisposure.com/Events/2008,,,0,72,72,43,0.000011
Wikisposure.com/Events/2009,,,0,88,88,43,0.000011
Wikisposure.com/Events/2010,,,0,47,47,43,0.000011
Lovesboys80,,,1,0,1,43,0.000011
Wil Sinclair,,,0,15,15,2,0.000011
Bawtism,,,1,0,1,24,0.000011
Sharlene Simon,,,1,0,1,39,0.000019
Win ED Tshirts,,,1,3,4,52,0.000026
Win ED Tshirts/Entries,,,1,1,2,52,0.000018
Wingsofirewarriorcat,,,0,28,28,24,0.000011
Winko567,,,0,19,19,36,0.000011
Winnebago Man,,,0,3,3,61,0.000011
Wiz Khalifa,,,0,46,46,6,0.000011
Wizard101,,,0,3,3,29,0.000011
Wojti 2000,,,0,4,4,22,0.000011
Wolf punk,,,0,46,46,31,0.000011
Women In Horror Month,,,0,4,4,39,0.000011
Gagdub,,,1,0,1,17,0.000012
Woody Allen/Filmography,,,0,9,9,5,0.000011
Sissies,,,1,0,1,60,0.000011
Mani,,,1,0,1,60,0.000011
World Wide Chat/Users,,,0,1,1,20,0.000011
World chan-art gallery,,,0,3,3,37,0.000011
Wpcomment.sh/code,,,1,0,1,10,0.000014
X,,,0,26,26,9,0.000011
XPstar214,,,0,1,1,7,0.000011
XZeroPoint,,,0,16,16,10,0.000011
Xallyfacex,,,0,12,12,58,0.000011
Xbox Live/Xbox Moron Saga,,,1,4,5,62,0.000011
Xd,,,0,2,2,10,0.000011
Guessing,,,1,0,1,46,0.000011
Masturbator,,,1,0,1,31,0.000011
YIFY,,,0,3,3,10,0.000011
Yaoilover113,,,0,1,1,22,0.000011
Whiney,,,1,0,1,11,0.000011
Weak sauce,,,1,0,1,48,0.000012
YouTube Community Council,,,1,1,2,17,0.000019
YouTube's Community Guidelines,,,0,9,9,58,0.000011
YouTube Ancient,,,0,90,90,48,0.000011
YouTube Poop: The Movie,,,0,50,50,32,0.000011
YouTube Red,,,0,16,16,48,0.000011
Your Angelica,,,0,4,4,48,0.000011
Your Email/The Hideous Shark,,,1,0,1,64,0.000012
Turn on,,,1,0,1,54,0.000029
Your user space/your article name,,,1,7,8,52,0.000011
Antihero,,,1,0,1,28,0.000012
Only 9000,,,1,0,1,50,0.000011
Epic results,,,1,0,1,32,0.000011
Zac Penton,,,0,3,3,35,0.000011
Babysitter,,,1,0,1,34,0.000011
Childless,,,1,0,1,26,0.000012
Zeitgueist,,,0,31,31,35,0.000011
Zeriara/ImageGalleries,,,5,7,12,21,0.000014
Zeriara/Sunday's mail chatlogs,,,1,1,2,21,0.000012
Zoe Askalon,,,2,1,3,2,0.000013
Zoe Comnena,,,1,21,22,2,0.000013
Zoe Comnena/Pierce,,,1,7,8,2,0.000011
Zoo (movie),,,0,29,29,31,0.000011
Zoomer,,,0,6,6,19,0.000011
"ˈgɹæfɪk trænˈskɹɪpʃən",,,0,13,13,3,0.000011
"Растишка/English",,,1,31,32,17,0.000011
